Tweets,Favorite,Retweets,Engagement,Sentiment,Tweet Length,Exclamations/Questions,Capital Letters,Passion
Ideas For Dems focus instead of #Bernie & Jane marriage analysis: #CHIP #FightFor15 #Medicare4All #Tax2ScamBill #DakotaLeak #ImpeachTrump #TrumpResign  #EqualPay #EndCitizensUnited #Gerrymandering #VoterSuppression #ElectionFraud #War #vote2018,1,1,2,0.0,244,0,36,36
"Not working @SacPolice  anymore isn't good enough when it comes to KILLER COPS! We want justice not paid retirements! Anti-Black TERROR can't be washed away @Mayor_Steinberg  
 ",36,16,52,0.35,178,2,27,29
"TRANSLATION: ""We stand w/ #racist #liberal #black #hate & #boycott a #white #GOP #POTUS visit to dedicate #MSCivilRightsMuseum?THEN tweet ""#NoHateInOurState""???#CivilRightsMuseum 

#TheResistance  #democrats never cease proving what #hypocrites they are??? ",0,0,0,-0.32222222222222224,259,0,42,42
???????? Coding to Fight Police #BlackExcellence  ,3,3,6,0.0,50,0,8,8
Guess I?m becoming an @Eminem fan? Listen to #Untouchable   #institutionalracism #artivism #MusicIsLife,1,0,1,0.45,103,1,11,12
"I Just Went To @BurgerKing and The employees were so rude and treated me with disrespect, i ask for a tray and sauce One of the employees throw it on the counter like they didn't want to touch my hand because I'm black. #RacistPlaces #WhyBeRacist #Burgerking ",19,15,34,-0.2333333333333333,259,0,18,18
WE ARE NOT FOR SALE! FIGHT AGAINST LIBYAN SLAVE TRADE!  #LibyaSlaveTrade ,2,1,3,0.0,73,2,62,64
".@realDonaldTrump - One year into your presidency, it?s clear what African Americans ?had to lose.? ? Healthcare, economic fairness, civil rights protections, voting rights protections, and an appreciation that black lives matter. #CivilRightsMuseum ",63,35,98,0.03333333333333335,250,0,12,12
Check out the article & support #BlackBusiness #blackbusinessowner @MelaninOrigins  @need_justice9 @ShaunKing @blk_slv_master @ShannonSharpe @yourrightscamp @Kaepernick7 @PurposelyAwake_  #ColinKaepernick #BLM  #blackpublisher #blackwriter  #BlackOwned #SNRTG ,4,1,5,0.0,260,0,27,27
 #PharrellWilliams: ?It rains and they shoot black people? | Music | The Guardian ,0,0,0,-0.16666666666666666,82,0,9,9
"""Once you go , you're betting your career on a loser."" ",0,2,2,0.0,55,0,4,4
"My neighbor saw me wearing  t-shirt this morning and said: ""eughh.... How can you wear that t-shirt? They're commie, marxist, rabble rousers..."" We had a bit of back and forth. As we were parting ways he ended the chat with ""merry Christmas!"" #neighbors",6,0,6,0.0,253,2,9,11
"This is so unbelievable, and shakes faith in the jury system just for starters.  ",0,0,0,-0.25,81,0,4,4
Systemic racism is killing black women in childbirth.  ,13,10,23,-0.16666666666666666,55,0,4,4
Class Unity by . Full respect to them! ,15,11,26,0.4375,39,1,6,7
"#IAmTheResistance 
I am a pro-choice mother of 3.
I am a rape survivor.  
I am an environmental activist that very much fears for our planet.
I #resist the @GOP & @realDonaldTrump because I stand against racism, sexism, xenophobia, classism and a police state.  ",26,5,31,0.26,266,0,17,17
"Case #1091 of the #AllLivesMatter + #WhiteLivesMatter + all cryptofascists UTTERLY SILENT + NOT CARING AT ALL when Big Gov't gun thugs murder White people.

I guarantee you that the people who support  care far more about justice for your people than you do. ",3,0,3,0.12,261,0,41,41
Talking about  and #blackhealthmatters and you already fantasizing on how to best your unborn defensless kids into submission.,0,0,0,1.0,126,0,4,4
?It is because of #NetNeutrality rules that the internet is the only communication channel left where Black voices can...be heard.? @OsopePatrisse of . Keep our movements strong. Come out Dec. 14 and demand the FCC protect Net Neutrality. ,51,42,93,0.053333333333333316,239,0,17,17
"America, here is another example of why a top down overhaul of our judicial system is required.
Attention :
It is not the color of your skin by which you are judged but by your deeds. #Kaepernick #BoycottNFL #BoycottESPN",4,5,9,0.17222222222222222,222,0,16,16
"lol... #WhitePeopleProblems

queue numerous vids of Alexa being thrown out windows (like their #Keurig boycott)

#Alexa #BLM  ",0,0,0,0.4,130,0,12,12
"""Let's say"" I'm a #racist  piece of shit who calls people ni**er until they beat me to a pulp.   @realprponline #MAGA ",0,0,0,-0.2,118,0,9,9
: Who Was Latandra Ellington? ,0,0,0,0.0,30,1,7,8
#MeToo #IamtheResistance Granddaughter of Immigrants Mother Daughter Sister Aunt- I Stand with #PrideLGBT#Immigrants #Disabled   #Dreamers #Womensrights #Indigenous  #Earth ,2,0,2,-0.2,173,0,26,26
"Where are all the whites on this, making this is aware. My thoughts and prayers go out to Daniel Shaver family, but now this whole ?#AllLivesMatter? can understand why we preach  when we do. This video is just disgusting ",4,1,5,-0.18333333333333332,221,0,11,11
"Thank you to @PostCity for this honour of naming me most inspiring woman of Bayview, where I grew up (reading the Bayview Post!). And thank you to @DesmondCole for the lovely article. Thanks for recognizing all the work we at  put in for the city ?? ",117,25,142,0.45625,250,1,14,15
"A clunky and somewhat misleading headline from @washingtonpost 

#Race 

#NotMyPresident 

 ",0,0,0,0.0,98,0,8,8
"Looks like the #AztecSchoolShooting perp is a white asshole

When media hides 12000 annual murders by black thugs from the Stack Money Goons & Trav Family & Very Crispy Gangstas,  has a narrative when black-on-black & black-on-white crime is concealed

#Trump2016",2,1,3,0.011111111111111118,267,0,17,17
"Say their name. Alton Sterling, 2016-07-05 .",0,0,0,0.0,44,0,6,6
You deserve all good things life has to offer. #TrapaDrive #SediLakaMusic  ,5,1,6,0.7,75,0,9,9
Thinking About Remaking Black Wall Street ,1,0,1,-0.16666666666666666,42,0,6,6
"?Lock Him Up!? ?It?s Mueller Time!? happening now in #Jxn #Mississippi.
 #UnityMS 
#MississippiCivilRightsMuseum #MS200 #LockHimUp ",46,20,66,0.0,133,2,23,25
"I honestly feel sick after watching this. This is precisely why #metoo and  exists, flaws and all. ",14,3,17,0.09523809523809523,99,0,2,2
"#IAmTheResistance I am a small business owner, a wife, a daughter,a granddaughter of immigrants, a parent to a child with special need. I resist the @GOP and @realDonaldTrump because I resist racism, misogyny, and oppression. #metoo  #EqualityForAll",10,6,16,0.053571428571428575,249,0,18,18
Again...black on white crime with little consequence #BlackLives do not matter to me if #WhiteLives don?t matter to them.  #liberals #diversity #Whiteguilt ,0,0,0,-0.09375,156,0,9,9
Joyner Lucas - I'm Not Racist | SquADD Reaction Video  via @YouTube WATCH THE VIDEO!! BE EDUCATED!! ,0,0,0,0.0,100,4,39,43
 THIS IS HOW THOSE LIKE @MonitoringGroup WHO ARE THE BEST WE HAVE FOR  FOR #TOTTENHAM,0,0,0,1.0,85,0,57,57
"This is what you would call, WHITE PRIVILEGE??
If the person was white. 

Is this called BLACK PRIVILEGE??

#BLM
#LIBERALS
#THUGLIFE

#Antifa ",1,0,1,-0.05555555555555555,151,0,67,67
How America's new generation of #civilrightsactivists is mobilizing in the age of #Trump  #getwoke #politics #Trumpism  #TheResistance ,0,0,0,0.13636363636363635,135,0,9,9
How America's new generation of #civilrightsactivists is mobilizing in the age of #Trump  #getwoke #politics #Trumpism  #TheResistance ,5,5,10,0.13636363636363635,135,0,9,9
"Seriously why isn't there more outrage over this case. #BLM if you want to highlight examples of police abuse this is a good case to get outraged about, or do you only care when the victim is black? I'm calling you out  ",0,0,0,-0.039285714285714285,220,1,8,9
"[AWARDS] I'm very excited to have been asked to judge and to present tonight's Media, Arts & Entertainment category at @apnireland's Excellence Awards, at @lilliesdublin!

Celebrating #blackexcellence in Ireland.  ",1,1,2,0.24375,216,1,17,18
Wakey Wakey you've been duped by the #blackcaucus  ,0,0,0,0.0,51,0,4,4
Teressa Raiford is a well-known  activist and now she's running for mayor of Portland ,50,27,77,0.0,86,0,6,6
White People Are Upset That #Amazon?sAlexa Believes  -  via @TheRoot ..........     ,0,0,0,0.0,84,0,13,13
"The #SocialMedia year in review: The most-tweeted activism hashtags in the US in 2017
#Resist
#MAGA
#ImpeachTrump
#TrumpTrain
#WomensMarch
#NotMyPresident

#NoDAPL
#TakeAKnee
#BoycottNFL ",1,4,5,0.0,197,0,35,35
"Did you see all the RIOTS & BURNED DOWN NEIGHBORHOODS? 

Neither did I. Shows you who the ANIMALS/SAVAGES really are! 

#BLM
#liberals
 
#TheRealThugs ",0,0,0,0.047222222222222214,158,2,55,57
Systemic anti-white racism  ?? ,0,0,0,0.0,31,0,1,1
"Jackson is 80% black w/ 6th highest murder rate in US. Only 6% of kids are proficient at reading, and mayor is anti-choice and anti-charter school.

 don't matter here.
#MississippiCivilRightsMuseum ",2,0,2,-0.08333333333333333,202,0,11,11
"Hmmm... Why are there no Blacks  Hispanics on ##MuellerInvestigation ?Only Old white dudes who routinely, if they don't kill minorities, put them in jail. #superpredators",0,0,0,0.0,170,1,11,12
"Murderous duo. Disgusting.

 
#DemilitarizePolice ",0,0,0,-1.0,53,0,4,4
"When your job involves life-and-death decision making, the standards for conduct simply must be higher than this. The structures that insulate police from accountability must be torn down. #DanielShaver  #unarmed #deescalation #gunviolence ",3,1,4,0.03148148148148147,240,0,4,4
"#BaltimoreRising does a great job of explaining the Uprising from many angles, and is a great example of how community organizing evolves from oppressed groups of people. ??",1,0,1,0.7000000000000001,173,0,6,6
#History won't silence #HERstory   #Decency  #DemocracyIsAVerb #Democracy #SaveOurDemocracy #WeThePeople #AMorePerfectUnion = #WomensRights #LGBTQ #LoveIsLove  #HumanRights #VotingRights  #ClimateJustice #Science #NOH8  #MotherEarth #STEM ,0,0,0,0.0,239,0,49,49
#History won't silence #HERstory   #Decency  #DemocracyIsAVerb #Democracy #SaveOurDemocracy #WeThePeople #AMorePerfectUnion = #WomensRights #LGBTQ #LoveIsLove  #HumanRights #VotingRights  #ClimateJustice #Science #NOH8  #MotherEarth #STEM ,0,0,0,0.0,239,0,49,49
The latest The Independent!  ,0,0,0,0.25,29,1,3,4
#History won't silence #HERstory   #Decency  #DemocracyIsAVerb #Democracy #SaveOurDemocracy #WeThePeople #AMorePerfectUnion = #WomensRights #LGBTQ #LoveIsLove  #HumanRights #VotingRights  #ClimateJustice #Science #NOH8  #MotherEarth #STEM ,0,0,0,0.0,239,0,49,49
"Don't fall for Trump's visit to Jackson and his championing of civil rights, he just wants you on side for his own benefit ",2,0,2,0.4,123,0,6,6
#History won't silence #HERstory   #Decency #DemocracyIsAVerb #Democracy #SaveOurDemocracy #WeThePeople #AMorePerfectUnion = #WomensRights #LGBTQ #LoveIsLove  #HumanRights #VotingRights  #ClimateJustice #ClimateScience  #STEM #MotherEarth,1,0,1,0.0,238,0,47,47
#History won't silence #HERstory   #Decency #DemocracyIsAVerb #Democracy #SaveOurDemocracy #WeThePeople #AMorePerfectUnion = #WomensRights #GirlsEmpowered #HumanRights #VotingRights  #ClimateJustice #ClimateScience #STEM #MotherEarth #NOH8,0,0,0,0.0,239,0,44,44
"when he stands up for others, has good grammar, respects women, doesn?t give in to the heteronormative ways of the world, supports , like thrillers & superhero cartoons, & likes sensitive boys & aims to understand their emotionality. ? ",4,3,7,0.4,236,0,0,0
"Hey  will you please beat up pajama boy lol

His outfit is just insulting to all lives ",0,0,0,-0.09999999999999998,89,0,5,5
"Right or left, black  white, this is wrong. This cop is a PIG
This cop deserves to die.

I don't believe in the  movement. I don't believe this was racially motivated.
This is a case of a psycho cop that should be killed.
#BlueLivesMatter

",0,0,0,-0.0968253968253968,247,0,12,12
"A white guy was murdered by police and we hear about it from  

Pointing it out for the #alllivesmatter trolls, not you. ?? ",1,1,2,0.0,126,0,2,2
"Trump's controversial remarks on race @cnn #Resist #ImpeachTrump  #RoyMoore  

",0,0,0,0.55,81,0,9,9
Just saw the unreleased Mr Bean sketch where he attends a  protest,0,0,0,0.0,66,0,6,6
Still wondering why we say ? This. This is why. ,0,1,1,0.0,48,1,6,7
This is unacceptable @NBCNews #naacp  #DougJonesForSenate #dougjones this headline is disgusting ?Jones needs black voters to beat Moore in Alabama: They are not there yet? #blm  why not just VOTERS wow #usa #alabama this is offensive & wrong ,2,4,6,-0.39166666666666666,243,0,19,19
Inside . How America's new generation of civil rights activists is mobilizing in the age of Trump ,1,0,1,0.13636363636363635,98,0,7,7
"A RACIST, BIGOT like #DonaldTrump shouldn't be anywhere near anything involving CIVIL RIGHTS let alone the opening of a Civil Rights Museum. I don't recall ANY of the #GOP attend The 50th Anniversary of Selma except GW Bush & wife Laura.
 
",0,0,0,0.1,242,0,45,45
What a #Racist. He's mad because #Alexa said that  ?? ,0,1,1,-0.625,54,0,7,7
"Twilight Zone 2016:
 legally protest police killings of unarmed citizens & @FoxNews calls them unpatriotic & terrorist.
Twilight Zone 2017:
@FoxNews denounce the FBI & have a love affair with Russia & Vladimir Putin.",0,0,0,0.35,219,0,17,17
"""Welcome to the all black party!""- @ahagazelle 

#book #comingsoon #scifi #fantasy #blackmagic  #writerslife #Christian ",0,0,0,0.19722222222222227,122,1,5,6
Beneath the Skin: Episode 2   ,2,2,4,0.0,30,0,6,6
"""Being white is not a race or a culture""
Then why do you blame 'whiteness' for everything?

#ItsOkayToBeWhite is the same argument that  made about their name: ""this doesn't mean we hate the other races"". Which is the same argument Feminists made about men. ",1,0,1,-0.20625,261,1,12,13
Natural selection will favor mixed people.#MixedExcellence #MixedReality   #AllLivesMatter,0,0,0,0.05,90,0,11,11
"Doug Jones defends his record against #RoyMoore's lies.  He supports #2A and he's AGAINST late-term #abortion.

ELECTION IS DECEMBER 12

Vote for the candidate who tells the truth:  Vote #DougJonesForSenate 

#SaturdayMorning #ALSen #FBR #UniteBlue  ",6,3,9,0.0,256,0,50,50
"Modern American police descend directly from slave patrols. It shows.
#policestate #dogs 
",0,0,0,0.10000000000000002,92,0,6,6
It is #Racist and pure #Bigotry that  should have to read and interpret graphs displaying it is their AA counterparts who disproportionately commit more violent crimes on US citizens.,0,0,0,-0.02857142857142858,183,0,10,10
"#ThingsITrustMoreThanFoxNews If I'm a #brainwashed #AltLeft #TheResistance #antifa #feminist  #democrat:

#Liberal #MSM #FakeNews #propaganda. Which is why #libtards are the minority & THIS has happened to the #DemocraticParty???#TheMoreYouKnow? ",0,1,1,-0.1,248,0,33,33
I never knew that @amazonecho was WOKE. #alexa  ,2,0,2,0.0,48,0,5,5
 #AIRITOUTRADIO #rap you don't need street cred when you got money ,0,0,0,0.0,67,0,13,13
"In 2017, in the United States, unarmed Black people are murdered, point-blank, on their knees while inmates not even convicted of a crime are shocked to death. WE NEED JUSTICE. #DanielShaver  ",2,0,2,-0.4333333333333333,192,0,22,22
Damn right  out here for Daniel Shaver. The media not gonna show that tho.,1,4,5,0.2857142857142857,74,0,7,7
#NAACP You guys are the Rasist Bastards treating the President of the UNITED STATES like he dog shit on your shoe FK YOU and the #Assclown  Another bunch of Rasist Bastards,0,0,0,-0.2,172,0,31,31
"Thank you @Beyonce our beautiful black queen. This art is so important to the movement. #BlackGirlMagic #BlackGirlsRock  #EverybodyBlack #ForTheCulture
#NowPlaying the video ""LEMONADE"" in @tidal ",0,0,0,0.3611111111111112,196,0,27,27
"It feels like I have been saying this for quite a long time, but I strongly believe in #CampaignZero. ?

 

",0,1,1,0.19166666666666665,112,0,8,8
DONALD TRUMP SPEAKS AT THE MISSISSIPPI CIVIL RIGHTS MUSEUM OPENING: Why was this site not surrounded by black people 2 bar him from entering the premises?  #Antifa #HBCU #NAACP #MLK #BlackTwitter ,2,0,2,-0.16666666666666666,196,1,73,74
"Let?s make black boys whole in 2018 ! 

#BlackBoys2Men 

Fostering community, emotional and mental and healthy support systems. 

#BlackBoyJoy #BlackBoyMagic ",1,0,1,0.09666666666666666,164,1,14,15
Black Lives Matter. Just not the little unborn baby black lives that are aborted every day. #BLM  #hotep,0,0,0,-0.17361111111111108,104,0,10,10
 founder Alicia Garza to speak at Skidmore ,0,0,0,0.0,43,0,6,6
Notice how  activists are the ones shouting the loudest about Daniel Shaver. It?s about police accountability ,2,1,3,0.0,110,0,4,4
"Because I can't divert resources to all of these causes but want to at least take a clear stand:

I support

 
#TakeAKnee 
#NoDAPL 
#metoo
#noABA
#DisabilityRights
#UniversalIncome 
#AnimalRights 
#TaxTheRich

And probably many more I might add if I remember.",6,2,8,0.2,273,0,29,29
" organizing principles: 1. Lead with love 2. Low ego, high impact 3. Move at the speed of trust. Via @angelinaburnett at #wowconference #joinocmovement",1,1,2,0.22,151,0,4,4
"since no one has been talking about this lately, let me just remind you: 

 !",5,1,6,-0.375,79,1,16,17
WE ARE NOT FOR SALE! It?s our duty to fight for our freedom and it?s our duty to win! ???? #libya #libyaslavetrade  globally #antislaverymarch #london ,13,9,22,1.0,151,2,16,18
"I got a copy of the @realDonaldTrump dossier.
OMG!

#ChristiansForTrump  @WomenforTrump #resist #Indivisible #ImpeachTrump #Antifa 
@hottiefortrump #MAGA

",0,0,0,0.0,161,1,19,20
Why was Philip Brailsford let off scott free? Daniel Shaver was in tears. Was there anything else they could do? I'm going to look into the case but I'm not convinced he deserved to die. .,2,0,2,0.4,188,2,11,13
Instead of childish #butthurt hashtags>#ThingsITrustMoreThanFoxNews perhaps #TheResistance #AltLeft #antifa #feminist  #democrat #snowflakes should figure if they'd LISTEN to #FoxNews instead of #libtard #propaganda they'd have been PREPARED on election night? ,1,3,4,-0.15000000000000002,261,0,31,31
another platinum track!  #followforfollow #likeforlike #newmusic #edm #drake ,0,0,0,0.0,77,1,0,1
All lives matter when  #DaairraHayden,0,0,0,0.0,37,0,3,3
"TOO MANY PEOPLE STAND BACK, INSTEAD OF UP. 
The people of #Jxn #Mississippi resist @POTUS?s presence at the new Civil Rights Museum. 
 #UnityMS #NotInMyMississippi #MS200 ",15,11,26,0.21212121212121213,173,0,56,56
Black Lives Matter ,0,0,0,-0.16666666666666666,19,0,6,6
I?ve noticed the #AllLivesMatter crowd seems to be sitting out another police shooting. I?m beginning to wonder if it was nothing more than an attempt to drown out .,28,14,42,0.5,165,0,8,8
"#SaturdayMorning 

@CNN has Paris Dennard on defending man who wants SLAVERY back!!!

Don't stain Medgar Evers' name.

Trump shouldn't have even been allowed in Civil Rights Museum after support for Roy Moore.



#TrumpPenceMustGo
",0,0,0,0.1,242,3,30,33
"Just like the Big Lie of ""Hands Up Don't Shoot"" with Michael Brown in Ferguson

#BlackTwitter  #1A  ",0,0,0,0.0,102,0,16,16
"116th St. #streetmural #streetart #streetsofnewyork
.
.
.
 
.
#kaepernick ? ",1,0,1,0.0,82,0,1,1
"WHO'S READY TO #BREAKTHECHAIN ""AND"" BUILD/CREATE #ABETTERFUTURE #ABETTERWAY? #CivilRightsMuseum #CivilRights #AfricanAmericans #ItsTime  #StandUp4HumanRights #ItsTimeToThrive #TheDecade ",0,0,0,0.2,186,1,83,84
we must magnify  until it is fully understood- study up and #expectus? ,0,0,0,0.0,71,0,0,0
"Beneath the Skin: Episode 2 - CNN
 ",0,0,0,0.0,36,0,9,9
Here we go. White ppl upset again. Why can't some of them just be at peace shiet. #shiet  @kpher ,0,0,0,0.0,97,0,6,6
 #metoo White privilege ,0,0,0,0.0,24,0,1,1
"I really just read a tweet about Daniel Shaver that was like ""hey , cops also kill white people unlawfully too! Stop complaining!"" as if they thought that was some sort of great stance and compliment to policing. ",2,0,2,0.3333333333333333,213,2,7,9
Trump speaking at the #CivilRightsMuseum #lowturnout and very little #applause praising the accomplishments of  #Mississipp  now he has to go and brush his teeth because he didn't believe a word he said #DumpTrump #moroninchief  #lawrence #trumprussia #cnn ,4,2,6,-0.24375,257,0,10,10
"This was fighting real Injustice
 and Colin Kaepernick are far from it ",0,0,0,0.15000000000000002,72,0,7,7
With all these wack ratchet so called reality shows... they choose to cancel @tvOneNews with @rolandsmartin!?! This says a whole lot to what direction they want to steer black folks.  #realnewsmatter ,0,0,0,0.016666666666666673,200,3,7,10
Get 'em @FWhitfield #CNN @CNN #Resist #Occupy ,0,0,0,0.0,46,0,14,14
Civil Rights Museum #IAmTheResistance  #AfricanAmericans #ItsTimeToThrive #ItsTimeToRise #Organize #Galvanize #Thrive #BLM #TheDecade ,0,0,0,0.0,134,0,28,28
"Now this tweet is some bullshit Joe. You don?t get it at all!
 ",0,0,0,0.0,64,1,6,7
Slavery Reemerges: What The Average Person Can Do!  #endslavery  ,0,0,0,-0.1875,65,1,11,12
"#Freedom is ultimately endangered when a people place too great an emphasis on rights and too little on responsibility 
Make ",0,0,0,0.2041666666666667,126,0,5,5
"VIDEO of a black man named OTE Head that was murdered in Chicago on Dec. 3, 2017 because he was exposing the fact that #KennekaJenkins was murdered by the Crowne Plaza hotel staff and the cover-up!!!   ",8,7,15,-0.3255208333333333,202,3,18,21
"#Intifa #Antifada #TheResistance #Antifa #Intifada #ISIS  #Occupy #QAnon

TERRORISM: The use of intentionally indiscriminate violence as a means to create terror, or fear, to achieve a political, religious or ideological aim... ",3,2,5,0.0,230,0,26,26
Trump speaking at the dedication for the #CivilRightsMuseum is like Hitler speaking at the dedication for a Holocaust Museum. So hypocritical and disgusting to listen to a guy who despises  and #TakeAKnee choke out words honoring civil rights leaders.,264,101,365,-1.0,251,0,14,14
Thank God it was short....@realDonaldTrump had to get on the golf course before it gets too dark I guess ,0,0,0,-0.15,105,0,8,8
"All ages out here in #Jxn #Mississippi to protest @POTUS?s presence at the new Civil Rights Museum. 
#UnityMS #NotInMyMississippi
#MS200  ",17,10,27,0.13636363636363635,140,0,23,23
All artist proceeds 2 charity-pick your price! Thank you @KajalMag 4 the #DeepBlueShe #Mutiny2Unity music video ?. Project feat 100+ artist/activists--many you will know! #MeToo  #MeTooWhatNext #diversity #LGBTQ #WeNeedDiverseBooks  #StandingRock #womensrights ,2,1,3,0.0,261,2,30,32
"After #Charlottesville, how dare @realDonaldTrump speak at opening of #CivilRightsMuseum Bless all of you who led the way.  ",0,0,0,0.0,124,0,11,11
Looking forward to all of your new anti-racist policies in the name of #MedgarEvers.  ,4,0,4,0.13636363636363635,86,0,6,6
"We are not for sale 
Shame on Libya 
#slaverymustend #shameonlibya ? ",4,3,7,0.0,71,0,3,3
We are trying to save you people but you don?t fucking get it. You never will. But I won?t let my people die needlessly because of your stupidity. Rip #DanielShaver ,1,0,1,-0.5666666666666668,165,0,10,10
"Live a Little !!! Now on Amazon Prime: 

A movie about a bar fight ending in an assault and the memory loss afterwards.

 #Affirmation #SupportIndieFilm #Trailers 
 ",3,2,5,-0.11492365056818182,170,3,14,17
"A 40yr hegemony of Negro Priest-Kings
We forget that Black Intellects championed pride
Make 
",0,1,1,-0.16666666666666666,96,0,11,11
#AfricanAmericans ARE WE READY TO WORK WITH @UN @AfricanUnion TO #BREAKTHECHAIN And #Develop OUR FUTURE??? #TheDecade #ItsTime #AfricanAmerican  #ItsOnUs #ItsTimeToThrive #TheDecade ,0,0,0,0.1,182,3,70,73
Not today Satan... #CivilRightsMuseum #NeverTrump  ,1,1,2,0.0,51,0,10,10
We are Kings and Queens?,0,0,0,0.0,24,0,6,6
"When American citizens automatically defer to power and refuse to listen to victims, we create an environment ripe for abuse and injustice. 

It happened with 
#pipeline 
#NativeAmericans 
#JimCrow

Now it's happening with #MeToo 
#RoyMoore ",9,7,16,0.0,249,0,15,15
With @potus AND #RNC Supporting This SOB Is There ANY Doubt That White Supremacists RUN THE AMERICAN GOVERNMENT? #UN #UNGA #AfricanAmericans  #StandUp4TheHumanRights #TheDecade ,0,0,0,0.08333333333333333,177,1,63,64
#SatMag @TheSun @guardiannews @DailyMirror @Daily_Express @thetimes @nytimes @Independent @TheCanarySays @TheVoiceNews @EBONYMag  @MoJGovUK @ProjectRaceUK @ITV_R @BBCWatchdog IF WE ARE #locked OFF. THIS WILL NOT BE FOR OUR FIGHT FOR JUSTICE. THIS IS TO STOP US ,0,0,0,0.0,261,0,99,99
"I stand against frauds of all kinds.
tRump is an obvious fraud who only cares about his own self interests. Far from MAGA trump & his cronies are tearing apart this nation!

I stand with #LGBTQ &  & #TakeAKnee 

 #IAmTheResistance",9,3,12,0.18125,235,1,22,23
In Hard Times © #SongsOfInnocence    #Democracy #WomensRights #LGBTQ   #Climate #Science #Peace ??????  #SaveNetNeutrality #StopTheGOPTaxScam #GOPTaxScam #DefendDemocracy #Democracy is not #Isms it's #Humanity ,0,0,0,-0.2916666666666667,210,0,40,40
"""The black community is my community - the LGBT community, too, and the female community. That is my community. That's me; it's who I am''.--Nate Parker
#Familygoals #MarketMelanin #SocialSaturdays  #Education  --> #blackexcellence #blackpower  #blackqueen ",2,2,4,-0.08333333333333333,258,0,16,16
The Long History of Black Officers Reforming Policing From Within:  #PoliceReform ,0,0,0,-0.10833333333333334,82,0,14,14
" happening now in #Jxn #Mississipi. 
#MississippiCivilRightsMuseum #UnityMS #NotInMyMississippi ",171,113,284,0.0,97,0,16,16
Some White People Are Upset That Amazon?s Alexa Believes Black Lives Matter  ,0,0,0,-0.08333333333333333,77,0,15,15
In Hard Times © SongsOfInnocence? SaturdaySongs    #Democracy #WomensRights #LGBTQ #SaveNetNeutrality #StopTheGOPTacScam   #Climate #Science #Peace ??????  so appreciated ! Truli??@Ikelaru ! #SaturdaySongs ,1,1,2,0.010416666666666656,206,2,36,38
#SatMag @TheSun @guardiannews @DailyMirror @Daily_Express @thetimes @nytimes @Independent @TheCanarySays @TheVoiceNews @EBONYMag  @MoJGovUK @ProjectRaceUK @ITV_R @BBCWatchdog YOU ALL SEEM TO SEE ME AS SOME SORT OF #reject THAT HAS NO WORTH TO HEAR MY #truth? ,2,0,2,-0.075,259,1,92,93
"?Black Lives Matter!?
Jackson #Mississippi residents stand together and raise their voices against @POTUS at the new Civil Rights Museum. 
 #UnityMS #NotInMyMississippi ",18,12,30,-0.03598484848484848,171,1,23,24
"#WhatIWantSantaToBringMe
More guns.
#acab #2a #2ndAmendment 
#fuckcops  ",5,2,7,0.5,75,0,12,12
"Clarke does NOT speak for my black community. Thank You Eboni for calling him out. #ImpeachTrump 
 
#StopPoliceBrutality 
#CivilRights ",1,3,4,-0.16666666666666666,138,0,17,17
Jones needs black voters to beat Moore in #Alabama. They aren't there yet.  ,0,0,0,-0.16666666666666666,76,0,7,7
"Until Black on Black crime results in cries of outrage
we do but turn truth merrily on its head. 
Make ",0,0,0,-0.16666666666666666,105,0,7,7
Good justice for #WalterScott  #jailkillercops ,0,0,0,0.7,47,0,6,6
"Diversity is about # of bodies. Inclusion is about culture. When you focus on diversity w/out inclusion, you?re putting a bandaid over the problem @deray @BoF #diversityandinclusion #costofdiscrimination #businessoffashion ",3,1,4,0.0,223,0,8,8
"How is that #WhitePrivilege,  bullshit working out for you?  Oh? I guess it happens to us, too... ",0,0,0,0.0,98,1,8,9
"How is that #WhitePrivilege,  bullshit working out for you?  Oh? I guess it happens to us, too... ",0,0,0,0.0,98,1,8,9
"Fight Anti-Blackness. Bcos at the root of every  and #africanlivesmatter protest we go to,this is what it always comes back to. Systematic, ingrained anti-blackness. #LibyaSlaveTrade #libya #protest #racism #useyourvoice #useyourpower #SpeakUp ",2,0,2,0.0,244,0,10,10
all lives don?t matter until  so this is incorrect ,0,0,0,0.0,51,0,3,3
The latest The Occupy News and Report!  #netneutrality ,5,3,8,0.625,55,1,5,6
Police Brutality has to stop in America! As citizens we must demand more from the people who are sworn to protect.#PoliceBrutality #StopPoliceBrutality #WhiteLivesMatter  #love #AllLivesMatter #PoliceTraining #DanielShaver #why @TYTNetwork ,0,1,1,0.5,240,1,26,27
"InterVarsity Answers Why  Was Included, but Pro-Life Group Was Not, at Urbana '15 ",0,0,0,0.0,82,0,15,15
Nothing short of murder #policemurder #policebrutality  ,2,1,3,0.0,56,0,4,4
"MT
""@SJusticeW:  is just a cover for people to say that #WhiteLivesDontMatter

Think about it.

Being black is not a race or a culture. 
All it is to be black is to part of racism and genocide.
#BlackLivesDontMatter"" 

#BoingFlip

",1,3,4,-0.16666666666666666,242,0,21,21
"cant believe we have to protest slavery in 2017, this is the fault of British Imperialism and it has to stop.  #NoMoreSlavery ",15,1,16,0.0,126,0,8,8
"If you are neutral in situations of injustice,you have chosen the side of the oppressor. #LibyanSlaveTrade #Libya  #africanlivesmatter #useyourvoice #useyourpower #protest #SpeakUp ",3,3,6,0.0,181,0,10,10
Sounds like slavery to the civil rights movement all over again. We have to stop allowing racist folks/organizations to control our communities.   ,2,0,2,0.0,147,0,5,5
There comes a time when silence is betrayal. #LibyaSlaveTrade #libya #useyourvoice #useyourpower  #africanlivesmatter #protest ,2,1,3,0.0,127,0,7,7
Big up the brothers and sisters representing at the #AntiSlavery2017 demo in London.  ,8,3,11,0.0,86,0,7,7
"#IAmTheResistance
I want a country where women lead.
where  & our #Dreamers & Muslim neighbors are embraced.
No #RoyMoore ",17,4,21,0.0,125,0,13,13
 demonstration in #hydeparkcorner ,1,0,1,0.0,34,0,3,3
The madness of having to protest against slavery in 2017 #libya  #africanlivesmatter #protest #libyaslavetrade #useyourvoice #useyourpower ,6,3,9,0.0,139,0,1,1
#DemBlackMamas 3 #BlackMamaCreatives @biblebeltblack @TheaMonyee @wrapsnboobs give u all the #BlackMamaMagic? ur heart can hold discussing raising #FreeBlackChildren in an unfree word while pursuing their own dreams. #BlkCreatives #PodsInColor #WOCAffirmation  ,2,1,3,0.6,261,0,26,26
"BLACK LIVES MATTER.

Stop racism. 
Stop tearing families apart. 
Stop killing our own people.
Stop gun violence against our own citizens.

#EnoughIsEnough 
 

 #ThingsITrustMoreThanFoxNews ",11,3,14,0.3444444444444444,199,0,33,33
Tanya Lucia Bernard x FOREMOST :  : ,0,0,0,0.0,36,0,14,14
"Black woman started the #MeToo 10 years ago.   As victims of the most sustained & socially sanctioned abuse in US history, this rallying cry was a silent scream. 
Here?s what actually started the #metoo movement, long before the hashtag ",0,0,0,0.052777777777777785,238,0,10,10
", and Black Health Matters, too: Reproductive Justice  ",0,1,1,-0.16666666666666666,55,0,8,8
"#activist understand the need to confront all #injustice  Speaking UP diminishes their power, and spreads social equity, we the #Dreamers #metoo  #LGBTQ #Muslims #Jews  need to protect&Speak up 4eachother- ideally if one group is under attack we all under attack ",0,0,0,0.4666666666666667,263,0,15,15
"DM to request graphic design.
Follow me @melaningraphics for more.
 #GraphicDesigner #GraphicDesign  #ART  #Graphic #Digital  #Melanin   ",2,0,2,0.125,139,0,13,13
"3 compelling stages in the exemplary American life & legacy of P.B.S. Pinchback, for the 145th anniversary of his becoming the 1st Af Am governor! #Twitterstorians   #TeachReconstruction ",2,1,3,0.28750000000000003,187,1,13,14
"Logo created for @Queen_Brianna16.
 DM to request graphic design.
Follow me @melaningraphics for more.
 #GraphicDesigner #GraphicDesign  #ART  #Graphic #Digital  #Melanin   ",2,1,3,0.125,176,0,16,16
"A white man denies housing to vets, Black man kneels during yall?s National anthem and y?all say we disrespecting veterans. Racism. It?s all about race in this country.  ",7,4,11,-0.08333333333333333,170,0,8,8
 founder Alicia Garza to speak at Skidmore ,0,0,0,0.0,43,0,6,6
"In other words,  is just a cover for people to say that #whitelivesdontmatter. This has to be the worst train of logic I've seen in a long time. ",0,0,0,-0.39166666666666666,145,0,4,4
" #BLM  #Amazon #Echo #Alexa - #GoogleMini doesn't have an opinion but as she says, she's always learning! #GoogleMini #GoogleHome #Google #Android #IFTTT",0,0,0,0.0,153,1,22,23
"Logo created for a client.
DM to request graphic design.
Follow me @melaningraphics for more.
 #GraphicDesigner #GraphicDesign  #ART  #Graphic #Digital  #Melanin   ",2,0,2,0.125,167,0,14,14
"#ArmyNavyGame is a tradition in my family to watch, can't wait. There will be no Ahole #TakeAKnee #nfl  #liberals or jackass   bull crap . Just the love of #football and the love of our #Military and #USA and of course #ArmyNavyGame  #BuildTheWall  #GoArmy #Trump",1,0,1,-0.08,263,0,25,25
"Logo for sale. 
DM to request graphic design.
Follow me @melaningraphics for more.
 #GraphicDesigner #GraphicDesign  #ART  #Graphic #Digital  #Melanin   ",1,0,1,0.125,156,0,14,14
Never forget the time I was marching with  and Santas were shouting ?get a job!? at us. FUCK #SANTACON ! #FUCKSANTACON !,0,0,0,-0.625,120,3,30,33
"NO way #Alabama's gonna let some RACIST PEDO SCUMBAG like #RoyMoore?? in the family, capisce?!!
#VoteDougJones #NoMoore2017 #AlabamaSenateRace  
#Metoo  
#TheResistance #CNN #ResistGangsta? ",6,5,11,0.0,193,3,41,44
"DONATE TODAY TO END DEATHS DUE TO OVERDOSES - 
#therapy #thisiswhoiam #rawmaterial #trump #donaldtrump #racist  #trumpsupporters  #demons #thugs #neonazi #bumfights  #lynch",0,0,0,-0.125,173,0,36,36
"December 2017: Black homeownership just hit the highest level it?s ever been in the history of our country.
",3,0,3,-0.16666666666666666,109,0,3,3
"In Jackson #Mississippi, @POTUS protestors now line the block, waiting for the presidential motorcade. P45 is expected for the opening of the new Civil Rights Museum. 
 #UnityMS #NotInMyMississippi #Jxn ",25,14,39,0.01818181818181817,204,0,23,23
"""I?m convinced that we black women possess a special indestructible strength that allows us to not only get down, but the get up, to get through, and to get over.""?Janet Jackson
#MarketMelanin #SocialSaturdays #blackexcellence #blackpower  #blackqueen #blackkings ",14,6,20,0.008730158730158727,265,0,7,7
"#ThingsITrustMoreThanFoxNews

That #LiberalismIsAMentalDisorder #CNNFakeNews @HillaryClinton is corrupt #DemocratsAreChildren  is a racist organization @ShaunKing or #TalcumX is one of the whitest people out there and #Twitter loves to censor",0,0,0,-0.5,244,0,31,31
Because  you racist ,0,0,0,0.0,20,0,4,4
#CivilRightsMuseum I wanna watch the protesters in MISSISSIPPI #RiseUp #NoGoingBack  #TrumpRussia #TrumpIsAWhiteSupremacist,0,0,0,0.0,123,0,30,30
"?Through this program I became wiser. If I hadn?t come here, I?d still be a small dumb ignorant obnoxious vulnerable simple-minded child.? - D, an AFJ participant #newbeginnings #SecondChancesWork #JuvenileJustice  ",3,1,4,-0.375,215,0,17,17
'Green The Church' Seeks To Mobilize Black Churches On Climate Change  via @HuffPostGreen ,0,0,0,-0.18333333333333332,90,0,14,14
"I'm a single mom of four, a pediatrician, and a Christian. I believe that

Healthcare is a basic human right.
Love is love.
Our diversity makes us stronger.
Science is real. 
Refugees and immigrants are welcome. 
No human being is illegal.
#IAmTheResistance ",51,28,79,0.15584415584415587,266,0,16,16
"My fellow white people, imagine that what you saw happen to Daniel Shaver was happening to white people across the country all the time. Starting to get it now? ",115,42,157,0.0,161,1,7,8
 Activists Angry They Can't Ban White People From PUBLIC LIBRARY MEETINGS ,1,1,2,-0.16666666666666666,74,0,32,32
This is unbelievable. I say again. Far more dangerous than our police are our courts. Only a small % of police abuse their power - but a huge % of court cases protect those abuses. Almost never finding racist and evil police accountable for their actions.  ,1,0,1,-0.13749999999999998,257,0,8,8
"#WhiteSupremacy Teach In tomorrow in Palm Beach! #blm954  
",0,0,0,0.0,60,1,9,10
A reminder that when you?re not considered a part of the ?public? you get little public safety.  #joyandjustice ,6,3,9,-0.0625,112,0,1,1
"#FATHERHOOD

Now as a young Black woman
Demonstrate your self-respect by neither speaking nor laughing at Volume #11

Make ",0,0,0,-0.033333333333333326,128,0,18,18
I #really NEED #MySon TO BE LAID TO REST AND TO DO THAT ALL THAT IS DONE BY THIS @UKParliament IS TO NOT #HELP BUT TO #shutdown MY #truth .  YOU KNOW HOW @cobbctylawless IS A #nastyparty WHOM AR ALL IN THE #UK #Government WHO HAVE NOW JUST BASICALLY DONE A #Dawn ,0,0,0,0.2,263,0,134,134
Chicago poet gets his due.  #arts #community #socialwork #education #humanrights  #MAGA ,1,1,2,-0.125,88,0,8,8
"I am comfortable in my skin! Because God makes no mistakes! ""Are you a Primadonna?""...#primadonnamagazine #blackgirlsrock  #BlackGirlMagic #beauty #style #fashion #glamour #sultry ",1,0,1,0.625,180,3,11,14
"#AskRoyMoore how proud are you of your wife Kayla's #racist posting?

ELECTION IS DECEMBER 12

#SaturdayMorning #DougJonesForSenate #ALSen #BlackTwitter  ",4,4,8,0.8,158,1,36,37
 #stophumantrafficking with @lisaSamuels13 ,1,0,1,0.0,43,0,4,4
This is really what?s happening.  #BlueLivesMatter #MAGA ,0,0,0,0.2,57,0,11,11
"...no soda, no candy, no children of undocumented immigrants, must apply in person.   ",0,0,0,0.0,86,0,3,3
 even to #alexa #AmazonEcho ???????? ,0,0,0,0.0,37,0,5,5
You can't make this up. @NJ_Ayuk making a heroic stand for the 1000 fake twitter accounts that like his tweet with the hashtag  ,0,0,0,0.09999999999999998,128,0,4,4
Truth.  #TheResistance #NAACP ,0,0,0,0.0,30,0,11,11
"If certain folks in this country were not so caught up on silencing the  movement, which seeks to eradicate Police Brutality and Abuse Of Power, then society as a whole would be closer to realizing the benefits of police reform.  No cop should be above the law! ",0,0,0,0.13809523809523808,262,1,10,11
Ghanaian President Embarrass French President With Shocking Speech  via @YouTube. #facts #slavery #LibyaSlaveTrade #whitesupremicy #freeafrica ,0,0,0,-0.5,143,0,16,16
WE ARE NOT FOR SALE! #nomoreslavery #freedom #endLibyanslavetrade #justice #breakthechains  ,1,2,3,0.0,92,1,19,20
 and Beyond Syllabus is complete. I'll share it on my website in a few weeks. This gone be ? #BlackProfessor ,1,1,2,-0.05,109,0,9,9
"LITERAL FLAG USE!!!

HERE'S HOW THEY FEEL ABOUT US!!!

#2017 #BLM  #BLMNews @Kaepernick7 @cthagod @MichaelEDyson @drboycewatkins1 @bomani_jones @MAL___ @michaelsmith @Combat_Jack @RealMikeWilbon @rolandsmartin ",1,0,1,0.0,214,6,59,65
"This is horrible to watch. He deserves justice. All unarmed people killed by police deserve justice. That shouldn't be an extreme viewpoint. Also, the victim was white, but  has been speaking up for him, bc they know just bc #blm doesn't mean other lives don't. ",0,0,0,-0.2625,262,0,5,5
#throwback to presenting my paper on feminist theory and  at the university college feminist society conference last year ?? ,2,0,2,0.0,125,0,0,0
"Watch NYXT for #HumanRightsWeek: our partners are shining a spotlight on , #disability rights, #humantrafficking, anti-#LGBT violence, the prison industrial complex and more now:  #HumanRightsDay ",0,0,0,0.1,196,0,18,18
"UK Drug Policy and the Fight for Black Lives 
 #blm #racism 
",3,4,7,-0.16666666666666666,63,0,7,7
"Remember this when they tell you that hard work alone determines if you're a winner in this place. 

 ",1,1,2,-0.2916666666666667,104,0,1,1
"Some like to counter the cause of  with #AllLivesMatter. Well, here's an unarmed WHITE dude senselessly executed by a totally out of control cop. ? Try rationalizing THIS America. BLM has a point. ",0,0,0,0.0,197,0,22,22
"When #SNCC was the  of the Civil Rights Movement 
 ",24,16,40,0.0,52,0,11,11
"Shootings that won't be protested by @Kaepernick7. Far worse judgment than anything  ever rioted over.

#DanielShaver #Brailsford

",1,1,2,-0.15000000000000002,135,0,9,9
" #taketheknee #colinkapernick #eminem #black #blacks
Yup...she's right
",0,0,0,0.05952380952380953,73,0,1,1
Former officer Philip Brailsford executed Daniel Shaver #JusticeForDanielShaver  #OppressedLivesMatter #PoliceBrutality,0,0,0,0.0,119,0,17,17
This animal tortured a retarded kid because he was white. Broadcast it. And walked.  needs to shut the hell up. Forever. ,0,0,0,-0.4,121,0,7,7
"Alicia Garza, Co-Creator of  Movement, to Speak at ODU ",0,0,0,0.0,55,0,12,12
Nothing has even happened recently but I know it?s happening and the thought of that violation of human rights hurttts ? ,0,0,0,0.0,121,0,2,2
Another black family robbed in anyway is mad painful cus it can happen to me anydayyy... I?m not untouchable and that shit hurts. the only escape is the money ,1,0,1,-0.3383333333333333,159,0,5,5
Is there a problem?  ,0,0,0,0.0,21,1,4,5
because you and @LorettaLynch prosecuted everyone from  protesters to soccer cheats. neither @BarackObama appointees indicted on treasonous misogynistic white supremacist in law enforcement or politics. even w. bush did more to fight organized white supremacists. ,0,0,0,0.16666666666666666,264,0,7,7
"anti slavery march london 2017

#AntiSlaveryMarchLondon 

Stay safe you all. #Libya #Slavery #MustStop #AllLivesMatter ",0,0,0,0.5,123,0,15,15
"Tragic news of US black churches burning, is a propaganda material for BennyWenda FreeWestPapua   #PapuaIndonesia #WestPapuaIndonesia",0,0,0,-0.33888888888888885,133,0,16,16
White people with   in their bio are always the absolute worst. ,2,0,2,-0.26666666666666666,64,0,4,4
".@aunjanuejlt @GenesisBe are my heroines, #TakeItDown :: Take down racism and the flags that honor it  ",2,1,3,-0.1555555555555556,103,0,9,9
The support was fantastic. Let's hope it makes a difference #EndSlavery #BLM  ,2,0,2,0.4,78,0,10,10
Live from the Libyan embassy #WeAreNotForSale  ,1,0,1,0.13636363636363635,47,0,10,10
What's his real agenda. @Kaepernick7 #blueracism #ShaunKing @NFL @nflcommish #NFL  @bluelivesmtr @BackThePolice @NatPoliceAssoc @w_terrence @wolfgangfaustX @49ers @steelers @MiamiDolphins @Seahawks @texashabanero ,1,2,3,0.2,213,0,23,23
Cold blooded  murder. It is sickening!  ,0,0,0,-0.8,40,1,5,6
"Tragic news of US black churches burning, is a propaganda material for BennyWenda FreeWestPapua   #PapuaIndonesia #WestPapuaIndonesia",0,0,0,-0.33888888888888885,133,0,16,16
.@GenesisBe @aunjanuejlt are in the #SilentProtest today while @POTUS makes a meaningless photo op appearance. Would love if he took the opportunity to make sure  instead ,22,18,40,0.16666666666666666,171,0,13,13
"Lol I feel like @RedPillBlack is out here trolling white people to make a quick buck. Shame on you for taking advantage of simple white folk. #BlackTwitter come look at this, does she even believe that  then again her smile screams #GetOut but #GetMoney boo boo.",0,0,0,0.2388888888888889,262,0,15,15
"Tragic news of US black churches burning, is a propaganda material for BennyWenda FreeWestPapua   #PapuaIndonesia #WestPapuaIndonesia",0,0,0,-0.33888888888888885,133,0,16,16
"Tragic news of US black churches burning, is a propaganda material for BennyWenda FreeWestPapua   #Jayapura #PapuaIndonesia",0,0,0,-0.33888888888888885,123,0,14,14
Taking a wild guess here that the off duty police sergeant is white and Walmart shopper black?  ,0,0,0,-0.022222222222222216,96,1,5,6
Hotep killed ,27,12,39,-0.2,13,0,4,4
Sad that we even need it but very innovative and.  intuitive. Kudosyoung man  ,0,0,0,0.07500000000000001,78,0,5,5
The latest The Independent!  #dwp ,0,0,0,0.25,34,1,3,4
??#UK March Today Against African Slavery? #endslavery #shameonlibya #libyaslavetrade #antislavery #ukmarchagainstslavery  ,19,7,26,0.0,123,0,7,7
"Tragic news of US black churches burning, is a propaganda material for @BennyWenda @FreeWestPapua  ",0,0,0,-0.33888888888888885,99,0,11,11
Anti-Slavery March - Libyan Embassy #AfricanLivesMatter  #EndSlavery #LibyaSlaveTrade ,14,7,21,0.0,86,0,16,16
"woke up with the image of #DanielShaver execution, and my tears fell all over again. His life didn?t mean a thing to that bastard who pulled the trigger. He wasn?t there as an agent of peace but of death. #thisisAmerica ",4,3,7,-0.3125,220,0,8,8
"Slavery of black people needs to stop! This is ridiculous! 

 #WHUCHE ",0,0,0,-0.3125,72,2,11,13
"True because the world just can't get enough of the aging white male perspective, @DesmondCole  ",1,0,1,0.0875,96,0,6,6
"Well, sadly we've all seen another police officer execute another unarmed man begging for his life. I can't bear the horror of the last few minutes of #DanielShaver 's life. Another acquittal. What will it take to convict a cop? #TakeAKnee ",28,17,45,-0.2333333333333333,240,1,12,13
Exactly! THIS is why #ColinKaepernick and others took a knee.  ,0,0,0,0.3125,63,1,10,11
It's at the 4 minute mark - the guy is clearly terrified and breaks down..it's at that point that's he's executed..  #MLK #BlackHistory #GunControlNow ,4,5,9,0.10000000000000002,151,0,12,12
"Kidnapping,torture, hate crime and all she got was a year.? Please explain #WhitePrivilege to me again?    #mega #maga #MakeAmericaGreatAgain #SaturdayMorning #SaturdayMotivation  #DoubleStandards",0,0,0,-0.8,196,2,17,19
"#PhilandoCastille, a beloved nutrition services supervisor in Saint Paul, MN, was tragically murdered by a police officer last year. Now, the community is doing the work Castille loved.

 #HandsUpDontShoot #RiseUpAsOne ",15,7,22,0.4666666666666666,221,0,19,19
Mad much ????   #BlackTwitter  ,1,0,1,-0.2125,31,0,6,6
"It's okay for blacks to taunt and finally attack whites with clubs.
It's not okay for whites to successfully defend themselves.
Got it. I'll try to remember that next time I'm out.
#WhitePrivilege 
 ",1,1,2,0.2,203,0,10,10
"White People Are Upset That Amazon?s Alexa Belieives 



Shared from my Google feed",0,0,0,0.0,87,0,13,13
The day white people actually grow a back bone and stand up to the racist bigotry spewing out of  will be a beautiful day..,0,0,0,0.2125,123,0,4,4
Sleeve tattoos became acceptable in policing after the Iraq war so they could allow mentally unstable and emotionally damaged vets into the  ranks. #DanielShaver  #BlueLivesMatter ,1,1,2,-0.05,180,0,10,10
I am giving this book to my booklover friends  #childrensbook ,1,0,1,0.0,62,0,4,4
Where is the rest of #blackcelebrities around the world.  Well done @NaomiCampbell. Raise your voices people. Protest works. People power works.  #Libya must stop this gross abuse of human rights. #LibyaSlaveTrade  #LibyanSlaveTrade  ,7,4,11,0.0,234,0,17,17
Maybe we should have listened to  . #PhilandoCastile #TamirRice #SandraBland #DejuanGuillory #DanielShaver ,1,0,1,0.0,107,0,14,14
"This Verizon's response to me. Really #Verizon really? They called my inquire ""feedback"".  ",0,0,0,0.2,91,1,5,6
"Fight Anti-Blackness. Anti-slavery demonstration outside the Libyan Embassy, London.  ",0,0,0,0.0,86,0,7,7
Being Black in US means taking out trash (while Handicapped no less) getting attacked by a K9 officer for 0 reason & then that K9 & his handler (who gets one a ONE day suspension) gets to keep their job. This should be an AUTOMATIC suspension & retraining.  ,0,1,1,-0.04166666666666666,258,0,23,23
?One dollar? ?A dollar each and for all! ? ,0,0,0,0.0,43,1,3,4
"Racism is taught in our society, it is not automatic. It is learned behavior toward persons with dissimilar physical characteristics.
-Alex Haley

#RESIST! ??
#TheResistance #Racism #StopRacism   #BlueWave #Resistance #FBR #VoteThemOut ",2,1,3,0.0,240,1,27,28
Exclusive Interview: Mumia Abu-Jamal Speaks About  and Police Violence  via @truthout,24,26,50,0.0,85,0,12,12
"I strongly disagree with 
Hate me for it but #AllLivesMatter",0,0,0,-0.18333333333333335,61,0,8,8
The City does not appeal to diversity.  Manager is terrible. Weather too humid.  #CardinalNation ,0,0,0,-1.0,97,0,6,6
At the Libyan Embassy in London fighting against #slavery  #EndSlaveryinLibya ,2,0,2,0.0,78,0,10,10
March against the enslaving and selling of Africans in Libya! How is this allowed to go on? This has to #StopNow  #AFRICANLIVESMATTER #slaveryinlibya #torturw #rape #murder ,2,1,3,0.0,173,2,28,30
"?For some strange reason I can never be what I ought to be until you are what you ought to be.  This is the way God?s universe is made; this is the way it is structured.? Dr. Martin Luther King, Jr. ",0,0,0,-0.05,199,0,13,13
Just observing all that white male privilege battling against the #CaliforniaWildfires helping to save people regardless of skin colour.  ,7,2,9,0.0,138,0,6,6
 I NEED ALL OF THOSE WHO ARE NOT SEEING ALL THAT I HAVE BEEN SAYING ABOUT THOSE WHO ARE IN @UKParliament WHO HAVE #Tottenham BELIEVING THAT  YET ARE THERE BIGGING UP THE #Enemy.,0,0,0,0.0,177,0,121,121
I hope to see this as a national story and that it elicits the equivalent outrage that would ignite if it were a person of color. Yet I don't expect that it will.  #BlackTwitter  ,1,0,1,0.0,179,0,8,8
"#DreamIn4Words Complete Justice Department reform #BlackTwitter  
#BlackExcellence",1,2,3,0.1,83,0,13,13
"Cops are allowed to execute black people in the United States. 
#BLM  #Kaepernick #whywekneel ",1,0,1,-0.16666666666666666,95,0,7,7
While this shit is fucked up & horrible & the man did not deserve to lose his life......how many situations like this have to happen where WHITE ppl get shot like dogs before everyone realizes the problem ain?t ?non compliant? suspects.  ,0,0,0,-0.26,238,0,9,9
Great turn out at #Slavery protest in #London. Refugees are welcome here #EndSlavery #Libya  #AntiSlavery ,31,21,52,0.8,106,0,12,12
 requires that #LiveBlacksVote. There?s no getting around it #AlabamaSenateRace ,0,0,0,0.0,80,0,10,10
 Files ,0,0,0,0.0,7,0,4,4
Dear #BLM  cultural appropriation doesn't exist...,0,0,0,0.1,50,0,7,7
#PharrellWilliams: ?It rains and they shoot black people?   ,0,0,0,-0.16666666666666666,60,0,6,6
"Say their name. Rodney Turner, 2016-01-04 .",0,0,0,0.0,43,0,6,6
"French #Antifa  

Propaganda islamists in France...

See the connections ? It was in 2011 ",1,1,2,-0.05,94,1,9,10
-  CAN NOT  be biased about this!,0,0,0,0.0,33,1,9,10
"- This unarmed white male got shot by a police officer!!! 

 has to make some noise this is exactly what they protest against!",0,0,0,0.10416666666666667,128,4,4,8
"""Trump knows he is where he is because of his appeal to racism and xenophobia. The people that want to divide the country are in his camp. They want to go back to the 18th century!"" Karim Abdul Jabbar said
 #PoliceBrutality #BlackTwitter #racism #NFL ",20,9,29,0.0,252,1,16,17
A  protest in #Knightsbridge has literally stopped traffic ? I'm happy to be late to work for this ? ,0,0,0,0.25,101,0,6,6
"#Thucydides... 'So little PAINS do the vulgar take in the investigation of TRUTH, accepting readily the first STORY that comes to hand.' #SaluteToService #USArmy #USNavy #USMilitary #USAF #WarOnTerror #WarOnDrugs  #Brexit ",0,0,0,-0.109375,222,0,43,43
On my way to the march against the enslavement of African people. #LybianEmbassy I hope to see you all there ? #Wematter  #Stopslaveryinlibya,1,0,1,0.0,141,0,7,7
Imagine being this pathetic ??????  ,0,0,0,-1.0,36,0,4,4
This isn't a scam or propaganda! This is reality for thousands of people!Do not be the person who lets this horrific crime go unnoticed.Things NEED to change; together let's make them!?? #stopslaveryinlibya #protectourbrothersandsisters  do not turn a blind eye ,1,0,1,-0.5416666666666666,262,3,8,11
Analysis | Nearly 9 in 10 black Americans think Trump respects people of color less than whites   #DumpTrump #BlackTwitter #News ,1,1,2,-0.16666666666666666,129,0,12,12
"The 4756 best images about  on Pinterest | Police departments, Grand jury and Police officer ",0,0,0,0.75,93,0,8,8
". @jimmy_dore @JayarJackson @libertytarian ur thoughts on this? 
 
#Untouchable @Eminem ",0,0,0,0.0,90,1,7,8
"Lest we lose ourselves in our own realities, let's not forget the immediate reality facing those in Libya - the victims of a trade that has allowed for the mass kidnapping, dehumanisation, and murder of millions since the 15th century. #Libya #whereistheoutrage ",11,8,19,0.6,262,0,3,3
 should like this! Do you support @POTUS efforts to help the #BlackCommunity? He's doing exactly what @BarackObama couldn't or wouldn't do. #Dems DO NOT SUPPORT #Blacks they enslave you!! ,4,6,10,0.390625,188,4,28,32
"The thing that hurts the most about this #NetNeutrality bullshit? Is that the neutral internet has given people of color a voice and a platform to be visible in a white world that suppressed us, this is another move to suppress our voice and power #BlackTwitter ",0,0,0,0.25,262,1,9,10
" people need to stop trying to put me in that ""oppressed"" or ""underprivileged"" group because I know I'm more privileged than any under $50k making household, homeless person and anyone who can't afford at least 3 meals a day! #checkyourprivilege",0,0,0,0.0625,245,1,5,6
" is an objectively better organization when they spend their time trying to save lives, not so much dragging their political opponents through the mud with absurd, divisive, unverifiable claims. ",1,0,1,0.04999999999999999,195,0,3,3
The latest Love 2 Love U Daily!   #trends,0,0,0,0.375,41,1,5,6
"Blacks kill blacks at 10x the rate of whites
35x the rate of Jews.
We rob our own lives of value. 
Make ",0,0,0,0.6,107,0,7,7
"So , does 'white privilege' include being pumped full of holes while on your knees?

#DanielShaver",1,0,1,0.175,100,1,6,7
"So what you're saying is...  , yes? ",0,0,0,0.0,36,1,4,5
"Eminem is back and this is the as intense as  can ever get, lyrics that are total political blast
""We're applying, but McDonald's
Seems to be the only franchise that'll hire"" 

",0,0,0,0.04,181,0,5,5
This is why we say  and why #AllLivesMatter is the dumbest ? ,0,0,0,0.0,61,0,7,7
Librarian Creates  Booklist for Teens | School Library Journal ,0,0,0,0.0,63,0,10,10
My Air. My Water. My Soil!!!  #CorruptBastard #PathologicalLiar #FakeChristian #FakePatriot #MORON  ,0,0,0,-0.8,100,3,22,25
#DanielShaver  we been trying to tell y?all they will execute y?all too.  protects you too. Get on board,1,1,2,0.0,104,0,3,3
Hey #Alabama @MooreSenate longs for the times of slavery. Please get out and  vote @GDouglasJones on Tuesday and tell the world and @realDonaldTrump that you will have #NoMoore  #Resist #RoyMooreSexPredator #BLM,1,2,3,0.0,211,0,24,24
This was a murder! This black man committed no crime! He must've really liked the cops shoe though! #BLM  ,1,2,3,0.27083333333333337,106,3,9,12
"If you are a white man who didn?t get it, you can now say ?man, that could be me? too. Please use this to help yourself empathize and understand why  to everyone. Police killings are everybody?s problem. ",0,0,0,0.0,204,0,6,6
"Oh what a spectacular trio stellar luminaries! Shine brightly on, daily illuminating lives everywhere, individually & collectively, w/ your star-spangled talents, principled POVs, political smarts, social justice savvy, wit, wisdom & grace! 
#USA  #globalimpact  ",0,0,0,0.15902777777777774,264,2,11,13
 Camps At Police Station For 2 Weeks |  ,0,0,0,0.0,40,0,9,9
"How much y'all wanna guess this guy is a #Trump supporter , and against  @Nfl..
They are twisted....#whitemen ",0,0,0,0.2,111,0,7,7
"If you don't care about  - though you should - maybe you'll care about this. He's white, compliant, unarmed, and still murdered. If you never believed anyone else, know that THIS is the problem.

#PoliceBrutality #resist ",2,3,5,0.0,223,0,9,9
"'Please don't kill me' ?

The more you watch this, the more disgusting it gets.
How was this police officer acquitted of murder when he carried out such a clear, unprovoked, sickening execution??
 


 #USA #racism #MeToo @End_Police_Brut ",4,2,6,-0.13333333333333333,245,1,14,15
...Dear White People...now here is the opportunity to put those twitter threads about race to actual use. ,1,0,1,0.0,106,0,6,6
"The unrestrained use of force & the ridiculousness of being afraid we'll get shot while trying to comply with contradictory orders is what needs to change.

 #AllLivesMatter #KateSteinle #DanielShaver #Gunsense #PhilandoCastile #TakeAKnee

",1,0,1,-0.6,244,0,17,17
"#Amen ?????? SO MUCH SO THAT NOT ONE #SINGLE  #CAMPAIGN #GROUP HAS HEARD A SINGLE WORD OR EVEN SHOWED ME ANY KIND OF #SUPPORT WHAT SO EVER IN THE ONGOING #Coverup OF WHAT #BBCBias, @metpoliceuk @VictorOlisaMPS HAVE ALL DONE TO HELP KEEP IT QUIET. ",3,2,5,0.13142857142857142,247,0,156,156
"The unrestrained use of force & the ridiculousness of being afraid we'll get shot while trying to comply with contradictory orders is what needs to change.
 #AllLivesMatter #KateSteinle #DanielShaver #Gunsense #PhilandoCastile #TakeAKnee

",2,0,2,-0.6,242,0,17,17
DeRay McKesson of  Tweets Claim That Virginia Shooter Was White | John Hawkins' Right Wing News ,0,0,0,0.14285714285714285,96,0,19,19
  REST IN PEACE PEDRO PIERRE. JUSTICE. NEEDS. TO. BE. SERVED. ,0,0,0,0.0,62,0,47,47
After #DanielShaver let's just stop the bs and admit that #AllLivesMatter was just a rebuttal to  to silence black people fighting for accountability and justice from the court system.,1,0,1,-0.16666666666666666,184,0,9,9
" ,is fighting for #DanielShaver because 1 of their core goals is to stop the murders of unarmed people by police with no accountability. #AllLivesMatter is silent on this.",2,0,2,0.0,171,0,8,8
"White officer kills white man #whitelivesmatter wait that doesn't work, let me ask  would you protest as shaver wasn't black?wait of course not. Hmm I suppose we just shouldn't care. Anyone watching football later? #PhilipBrailsfordYouCunt ",1,0,1,0.0,240,2,11,13
Day 15 - First Steps: Watch    #JamesBaldwin ,4,2,6,0.25,45,0,9,9
some cis people are chanting  but you're not the left,0,0,0,0.0,53,0,3,3
"A 40yr hegemony of Negro Priest-Kings
We forget that Black Intellects championed pride
Make 
",0,0,0,-0.16666666666666666,96,0,11,11
These things need to be addressed #Blm  #notonemore ,0,0,0,0.0,52,0,5,5
"I wonder if this Daniel Shaver video will, all of a sudden, help explain police brutality to those who haven't understood it so far ?  #DanielShaversLifeMatteredToo #EndSARS 
[GRAPHIC VIDEO] ",13,44,57,0.03333333333333333,192,0,28,28
"#Queens are like diamonds.
? Resilient, Strong, & Beautiful ?  



#quoteoftheday #Diamond #blackqueen #resilience #strong  #BlackTwitter #MelaninMagic #BlackWomenLead #boss #blackbusiness #ChristmasTimeIsHere #queening
#fauxloc #natural ",10,4,14,0.4541666666666666,244,0,19,19
America needs Justice not murderous police.  ,0,0,0,0.0,45,0,3,3
Just a reminder ... Because people get it twisted  #TakeAKnee? ,0,0,0,-0.5,63,0,8,8
"EVEN #Amazon has turned super #liberal now. I don?t want politics involved in this and many people are angry over what Alexa says.  is a terrorist group that promotes violence against whites and the police. 

HOW ABOUT,

#AllLivesMatter. 

",47,41,88,0.11111111111111108,246,0,21,21
"Special Counsel #Mueller website. Worth a visit:



#TheResistance #TheResistanceUnited  #RefusePolarization  #StrongerTogether",0,0,0,0.32857142857142857,131,0,16,16
"Privacy concerns aside, Alexa is right, ! White People Are Upset That Amazon?s Alexa Believes Black Lives Matter 

 ",3,2,5,0.06349206349206347,118,1,16,17
"Yep! If U need to see why the movement around  arose, then just see #FlintWaterCrisis & #PuertoRicoCrisis @drgoddess @ava ",0,0,0,0.0,122,1,12,13
Murdered in cold blood by the police.... No riots...... No looting... Take note  ,0,0,0,-0.6,81,0,7,7
Another unjustified police shooting another unjustified acquittal. When are people going to be sick&tired of being sick&tired? #TakeAKnee  #StopKillingUs  ,1,1,2,0.0,155,1,11,12
"Black Militancy was last gasp of Black Intellect.
Opposed by the Negro Priest-Kings who worship their master's god.
Make ",0,1,1,-0.1111111111111111,123,0,12,12
"DM to request graphic design.
Follow me @melaningraphics for more.
 #GraphicDesigner #GraphicDesign  #ART  #Graphic #Digital  #Melanin   ",0,0,0,0.125,139,0,13,13
Tomi Lahren Destroys Trevor Noah Over   via @YouTube,0,0,0,0.0,52,0,11,11
I can't watch videos of black people being abused by police. I just can't. I don't need to watch them to know that black men & women are suffering and that we need change now. ,0,0,0,-0.16666666666666666,176,0,6,6
It continues to horrify me that in America there can be such undeniable evidence of police wrong doing and yet no justice brought upon the gang in blue. #Quiscustodietipsoscustodes  #DanielShaver #BrendanDassey,1,0,1,-0.16666666666666666,210,0,10,10
This is a never ending nightmare  ,1,1,2,0.0,34,0,4,4
"Watch how the government will secretly implement Nkosinathis grey water system in Cape Town, I definitely suspect foul play! The partner is probably going to be given a large sum of shut up money to hand over the invention too,truly disgusting #RIPNkosinathi ?",1,0,1,-0.2471428571428572,260,1,13,14
"I'm in good hands. 

Reading From  to Black Liberation by Keeanga-Yamahtta Taylor. #RequiredReading ",2,0,2,0.26666666666666666,102,0,13,13
When you?re at the job Christmas party and your white coworker asks you ?why do  but all lives don?t?? ,0,0,0,0.0,103,1,2,3
Nice to see X-Wing pilots can be PoC now - except if they're cishet!  ,0,0,0,0.75,70,1,5,6
Watchin 42 ,0,0,0,0.0,11,0,1,1
"FreeQuency - ""The Joys of Motherhood"" (WoWPS 2015)  via @FreeQthaMighty  #Women4Women",1,0,1,0.0,85,0,17,17
I liked a @YouTube video   Smackdown in Seattle - Ben Shapiro,0,0,0,0.6,61,0,10,10
"Stupid police probably thought he was black

 ",0,0,0,-0.4833333333333333,48,0,4,4
"DMO DJ Bentley pulled over by Metropolitan Police Service  PC says it because 'Black people commit more crime'  IPCCNews   investigates, finds him not guilty of racism. I beg to differ.  #Justice4Nuno #NoJusticeNoPeace #PoliceBrutality http ://ow.ly/dtJ430h6M5E",13,17,30,0.19444444444444445,261,0,32,32
"We are the biggest victim but that is not just for #BlackPeople , US Police shoot dead American-Iranian citizen #BijanGhaisar ;
  #PoliceBrutality #WhiteSupremacy 
#NoJusticeNoPeace #NoJustice #Iranian ",6,5,11,-0.1375,204,0,24,24
Woman pleads guilty to hate crime in beating of disabled teen live on Facebook  ,0,0,0,-0.2727272727272728,80,0,2,2
"When black people protest shooting by the police of an unarmed black person, many white people are unsympathetic. But when it?s a white man who was armed who put down the gun but was shot anyway, they condemn the police. That?s why we have to chant  ",0,0,0,0.00185185185185185,250,0,3,3
Avalanche The Architect has created the biggest buzz in hip hop   #donaldtrump,0,0,0,0.0,78,0,3,3
This is another example of what @ShaunKing talks about.  ,0,0,0,0.0,57,0,6,6
this is as real as it gets!  #AvalancheTheArchitect  #hiphop #music #Drake #reggae #Toronto,0,0,0,0.25,91,1,5,6
#PoliceBrutality bullshit!  ,0,1,1,0.0,28,1,5,6
They must have shot him cuz he was black. Cuz thats all cops do right?  ,0,0,0,0.05952380952380953,72,1,3,4
This is no joke!   #music,0,0,0,0.0,25,1,1,2
"Late night link up with my bookie dckoko
#Ussie 
 #WeAreNotForSale  ? ",0,0,0,-0.3,72,0,10,10
"This is why  are literally a pack of #Holocaust inciting, #Nazi pieces of shit! #Neveragainincludesthedisabled :  ",0,0,0,-0.25,114,1,4,5
#denturedonald not inviting black people and #LGBT+ people to the #WhiteHouseChristmas is not an accident. Trump is just racist and homophobic and it?s that simple.  #LGBT,0,0,0,-0.08333333333333333,171,0,15,15
"Negro at 12% pop. is
50.6% HIV
52% Murders
76% NBA
68% NFL 
Content of our character? 
Time for change! 
Make ",0,1,1,0.0,117,2,17,19
Not Like This - #NoPrideHere By  NYC ,0,0,0,0.0,37,0,13,13
My heart hurts for Daniel Shaver and his family  #JusticeForDanielShaver  #OppressedLivesMatter #PoliceBrutality,3,1,4,0.0,112,0,15,15
#ICYMI: Can Being White Save You From A Fatal #Police Shooting?   #colorado,1,1,2,0.0,75,1,15,16
The latest The Occupied Australian!  ,0,1,1,0.25,37,1,4,5
"#Finally, A cop is being #punished for #shooting an #unarmed #blackperson - #globallycrooked #crooked #currption #systemicracism #hipocritas #Victoria ? #blackisbeautiful #poc #moc  #policebrutality #walterscott #nojusticenopeace #BHM ",0,0,0,0.0,235,0,6,6
Patriarchy & racism made Playboy possible & still hold societal reins today. If we?re very determined & committed the #metoo #YesHimToo &  movements might make a dent in them ,1,0,1,0.1,175,0,9,9
Why do people hate  again? #LAFires ,6,2,8,-0.8,36,1,7,8
"""American hero Kareem Abdul-Jabbar: 'Donald Trump is where he is because of his appeal to racism'"" #TrumpsAWhiteSupremacist #TakeAKnee  ",16,4,20,0.0,136,0,16,16
"Full story??
 #PoliceBrutality #NoJusticeNoPeace ",0,1,1,0.35,50,0,10,10
"that feeling when you're trying to give someone the benefit of the doubt but then you hear them say ""i think labels like 'feminist' and '' do more damage than good""",11,0,11,0.6,164,0,0,0
"That was so cold. Now you know what a police state is, select families born and bred, a caste of devoutly hateful people. The big secret is their hate is not just for blacks, but everyone. #whitelivesmatter  ",0,0,0,-0.45,208,0,3,3
"I was looking to see what countries I could move to and feel safer than I do in America. Turns out we're 60th, so I've got a solid 59 countries to choose from. #GunViolence #guns  

",4,1,5,0.0,184,0,11,11
Up from slavery  #slavery- ,0,0,0,0.0,27,0,1,1
"Multnomah County Data Analyst Fired For Sharing Racial Disparity Data
 
#blowthewhistle
#crimingwhilewhite  ",0,0,0,0.0,111,0,13,13
"This is why @Kaepernick7 takes a knee
This is why  came to be
Sickening to watch, yet we all must see this fucked-up reality ",5,5,10,-0.9,127,0,7,7
"Say their name. Jessica Nelson-Williams, 2016-05-19 .",0,0,0,0.0,53,0,7,7
I still can?t understand why that cop put his hand on his gun during a traffic stop.  He didn?t reach for the taser. My daughter and I both feared for our lives. And this is why we say ,0,1,1,0.0,185,0,8,8
"This. Is. Amazing. 

White People Are Upset That Amazon?s Alexa Believes Black Lives Matter  via @TheRoot #blm ",0,0,0,0.1444444444444445,113,0,19,19
 I insist get your law makers to ensure that each case where this has happened the jury is 50% ethnic minority. The views will be diverse and the conviction rate will start occurring ,0,0,0,0.0,183,0,4,4
"THIS.
THIS IS SOME SICK SH*T.
This VIDEO is some SICK SHI*T.
People knock , but THEY are the ones pushing for justice for this man.
Where are the #alllivesmatter #closetklan members now? ",1,0,1,-0.7142857142857143,191,1,41,42
"Couldn't have a rally without targeting black people, or a civil protest of police brutality . . . And his yelling capital letters, smh.  ",0,0,0,-0.16666666666666666,138,0,5,5
"I've always believed. I can't deny I see &hear.
 #POC
#MentallyIll
#Homeless
#LGBTQ
*All target populations
#MidtermMayhem? ",0,0,0,0.0,130,0,20,20
"It does suck to he considered subhuman. To be told by society that our lives are worthless.

It sucks.
 
#NativePeopleAreStillHere",8,2,10,-0.55,134,0,11,11
"Daily friendly reminder that #culturalappropriation is an #SJW lie, modern #Feminism want to to destroy the world, #nonbinary  there are only 2 genders, #Antifa and  are terrorist organizations",0,0,0,0.07499999999999997,193,0,9,9
"How is it that when  complains about implicit bias and institutional corruption by law enforcement at local, state, and federal levels, they are called unpatriotic but Gingrich can gripe mercilessly about FBI without any pushback? ",1,0,1,-0.35,231,1,8,9
"ICE detainees are asking to be put in solitary confinement for their own safety  via @Verge #DACA don't do prison labor,period. Don't military serve for GOP. Millennials ",0,0,0,0.25,170,0,13,13
"I can support  and still love, support, and respect the police. the two are not mutually exclusive",0,0,0,0.5,98,0,4,4
"An ICE detainee shouted ?No work, no pay? ? and got a month of solitary confinement  by @spencerwoodman #staywoke #DACA,don't do prison labor. Don't do military service ,everywhere",0,0,0,-0.1,180,0,10,10
 Activist DeRay Mckesson in Baltimore's Mayoral Race | DiversityInc ,0,0,0,0.0,68,0,12,12
. Kentucky Jail Sends Black Woman To Court With No Pants - This Judge Won?...  via @YouTube,0,0,0,-0.13333333333333333,91,0,17,17
"This is a police shooting video of a #WHITE man killed by an evil #cop who was ruled #NOT #GUILTY this is fucking insane  #AllLivesMatter #whitelivesmatter #protestpolicebrutality #policereform #justicedenied 
#WARNING video is graphic 
",0,0,0,-0.325,239,0,28,28
"The police have killed an average of 3+ people a day all year: 1111+ last I looked.
#FTP #ACAB #DanielShaver  #ALifeNotTaken (this time) ",0,1,1,-0.11666666666666665,138,0,18,18
? tchalisew: tchalisew: Memorial for our fallen soldiers  Please do not delete the... ,0,0,0,0.0,86,0,5,5
This news of Black teenager brainstorming this app to prevent police brutality has me both awestruck and heartbroken at the same time.  ,0,0,0,-0.08333333333333333,136,0,5,5
"The most recent episode of RadioEnless from @The_Logos_Club 
#WhiteDevils #albaniods #CynthiaG #blackpower  #politics #news
",0,0,0,0.25,126,0,13,13
"Dafonte, Yosif, Sami, Abdirahman & everyone else SAY THEIR NAME!! ?? #Community #Canada150 #Justice",0,0,0,0.0,99,2,22,24
 videos of violent police encounters.. This is why we #TakeAKnee  #CivilRights,0,0,0,-0.8,78,0,9,9
"SadStateOfAffairs
Must hold police accountable
Remove bad ???
Mandatory body cams
Retrain force?Restrain

#EnoughIsEnough ",1,1,2,-0.6999999999999998,128,0,15,15
"Really? An unarmed man can't be detained by TWO officers without getting shot? Who hires and trains them? Seriously? 
Do they get trained in how to take someone down with their own ARMS and body? 
 #JeanPIerre 
",0,0,0,0.07777777777777778,214,5,18,23
Stop the slavery in Libya.  #LibyaSlaveTrade #libyaslavery. Man inhumanity to man even to animals is unacceptable.,2,1,3,0.0,114,0,9,9
Thanks you  for being there for #DanielShaver.. We know all lives matter to you,3,1,4,0.2,79,0,7,7
Daniel Shaver was murdered. The  movement advocates for him too but they will only change their name to #AllLivesMatter when this shit happens every day to whites too.  End police murders. ,2,0,2,-0.1,189,0,10,10
If  Does Not speak out against this Unarmed man being Executed by a cop then your cause has lost its purpose!! @deray @rolandsmartin @angela_rye @JoyAnnReid @CapehartJ @TheRevAl @Kaepernick7 @BarackObama @B4IleaveU @sunny @itsgabrielleu @ACLU @Eugene_Robinson ,0,1,1,0.0,260,2,28,30
"4 those people who say they don't see color, they don't see me. I am not invisible.   ",5,0,5,0.0,86,0,2,2
"Hey , @deray, and @ShaunKing 

Why do none of you care about the Libyan slave trade activities happening? 
Is it that you?d only care if it were whites committing it?

",0,0,0,0.0,173,2,6,8
Hey  where's the outrage for this huh? This is real #PoliceBrutality ,1,0,1,0.2,69,1,7,8
"""We're really talking about humanism."" #WeWontGoBack #EveryWomanEveryDay  #LoveIsLoveIsLove #Indivisible ",0,0,0,0.2,105,0,18,18
#ALSenate   but not to #AbortionJones  his motto is Kill It Before It Grows ,0,0,0,0.0,76,0,13,13
"EPIX HD: watch 1000?s of BIG movies like Selma Online!  
 ",0,0,0,0.0,59,1,14,15
What y'all think about black people singing the anthem at nfl games??? #questions #nfl #KnowYourRights #ColinKaepernick #blm ,0,0,0,-0.16666666666666666,125,3,9,12
 Black maternal deaths: racism is deadly   via @ATuteur,1,1,2,-0.18333333333333332,55,0,6,6
A white guy is shot by Police on video and none of the mainstream media or anti #PoliceBrutality activists are talking about it. Tell me about the mystery of ?white privilege? again!  @CNN @FoxNews ,0,0,0,0.0,198,1,13,14
"A police dog attacked this woman as she was taking out the trash ? now she's advocating for policy changes ??

 #USA #American #racism 

#fabricedelamort ",8,8,16,0.0,158,0,8,8
"Here is a justified police shooting but  will im sure twist it , the thug had the officer on the floor held down #BlueLivesMatter .. Video is long so on a video host ",1,0,1,0.1736111111111111,166,0,8,8
"So, @amazon?s #Alexa supports , and - of course - #Conservatives are mad. Can?t imagine why, ? ? but I?m glad I bought a couple #Echo Dots for the family as #Christmas gifts. #EchoDot #Amazon #StayMad ",0,0,0,-0.0625,201,0,17,17
"Typical Family Net Worth- White $116,800 Black $1,700 New Study     ",1,2,3,0.017171717171717168,68,0,11,11
Hope the anti  crowd sees the full video and realize it would behoove them to get on board cause bad policing takes white lives too. ,0,0,0,-0.11666666666666665,133,0,1,1
Yall throw   around so much then wonder why no one takes the movement seriously..,0,1,1,-0.06666666666666665,81,0,4,4
"We have the highest black home ownership in history. 
Thank you @POTUS.
@realDonaldTrump
#BLM 
 
#Pensacola #MAGA #MakeAmericaGreatAgain #DrainTheSwamp",0,0,0,-0.16666666666666666,156,0,27,27
.shot Walter Scott five times as he ran away.  He then lied & said Mr Scott attacked him/took his taser gun! A LIAR! THANK GOD FOR VIDEO!  ,0,0,0,0.0,139,3,29,32
"""I CANT TAKE IT NO MORE!!""  The video
#HipHop4Justice #justiceorelse  #CulturalRevolution 
 ",0,0,0,-0.390625,94,2,26,28
"#NAACP  #AMJoy #CNN #MSNBC #Maddow #JoeScarborough @keithellison 
Black #racist sailor lies about white sailors scrawling racial slurs on his bed. How many incidents like this are staged? I bet lots more than reported ",0,0,0,0.20833333333333331,219,1,25,26
"Hey , where you at? #DanielShaver 

",1,0,1,0.0,38,1,6,7
There is a good reason  exists. ,1,0,1,0.7,32,0,4,4
 - An exploration of the  movement and social theory ,0,0,0,0.03333333333333333,53,0,20,20
Making The Railway Children trans flopped at the box office! I'm shrieking  ,0,0,0,0.0,76,1,5,6
It?s a shame that  is a fight over semantics rather than a battle of injustice.,0,0,0,0.0,79,0,1,1
Judge releases video of police shooting of Daniel Shaver after officer acquitted  .,0,0,0,0.0,83,0,6,6
You were great on @TheLastWord tonight.  ,0,0,0,0.8,41,0,7,7
Make sure you download Legal Equalizer today on Android?s Google Play Store! iPhone app coming Dec 11th. #legalequalizer #legalapp #legaltech #knowyourrights #policebrutality  #mobileapp #android #googleplay #app #lawyer #law #attorney ,3,3,6,0.375,236,1,9,10
I am aware of the social injustices that my people have faced and are facing today...& I still love Jesus. ?  #wokeandsaved,1,0,1,0.2611111111111111,123,0,3,3
"About time a white officer gets CHARGED for shooting an unarmed African American. You guys deserve justice for every unarmed black man and woman that were shot without getting justice. See? I'm white, not all whites are racist!  #Alllivesmatter",1,0,1,-0.03333333333333333,244,2,15,17
"What rhe fuck, Arizona?! How does this merit an acquittal?  shaver  ",1,0,1,-0.5,68,3,6,9
"And once again

#takeaknee
@nfl @Kaepernick7 @NFLPA ",1,0,1,0.0,55,0,7,7
"BAKE SALE 12/30

We get so much love from our bake sales. Join us. 

Bake. Donate. Share. 

 

",31,10,41,0.5,103,0,16,16
 #BlackProsperityMatters Black home ownership is the highest ever in the history of the country! ,1,0,1,-0.2083333333333333,97,1,7,8
"That BLM truly believes 
 #ThingsITrustMoreThanCNN",0,0,0,0.0,51,0,15,15
"Body cam captures police dog attacking innocent woman taking out her garbage...""oh there's a lady"" ... 52yr old Ms. Collins was an amputee...""help me!""...after 30 seconds...sued b4....officers still employed...  
",0,1,1,0.3125,214,1,6,7
And he loves St Louis. Unlike the  cop-haters who incite the criminals. How many murders so far this year? ,1,1,2,0.3,107,1,8,9
This is disgusting and where are you #AllLivesMatter people?  This is what  is talking about. ,2,1,3,-1.0,94,1,8,9
"""Rick and Teresa Kaepernick, who are white, adopted Colin when he was only 5 weeks old. The couple had lost two sons at birth to congenital heart failure...""

It might help racist @realDonaldTrump and his racist supporters to know this. #NFLBoycott #NFL  #Patriot ",4,0,4,-0.05416666666666668,266,0,16,16
Black Women Malled by police dog while taking out the garbage pleads for officers to help release the dog -more than 10 commands to release wasn't successful. The officer 1 day suspention-still working K-9!  #BlackTwitter ,1,0,1,0.4236111111111112,222,1,10,11
Liberate Our Brothers And Sisters From The Slavery that Is Mass Incarceration.  #LIFT #RISE ,5,5,10,0.0,92,0,22,22
"45 has no business at the civil rights museum.  He pardoned Arpaio, finds ""good people"" among Nazi's,  set Sessions up to deny civil rights , supports Moore & taking away voting rights.  #ResistanceIsImportant",22,9,31,0.7,209,0,11,11
#kidstoday. Brilliant young man. Tragic that high incidence of police brutality and abuse of authority combined with pervasive #racism  prompted a need for him to create it.  ,0,0,0,0.1025,175,0,5,5
"Agreed @FiveRights I was insulted when I heard ""Only white people can be racist"" but what about  Black Supremecy group? Should they not be treated like the KKK? It doesn't matter what side of the spectrum it comes from, any racial ""Supremecy"" movement is wrong. ",1,0,1,-0.16666666666666666,262,2,17,19
Ex-cop Michael Slager sentenced to 20 years for shooting death of Walter Scott  - ABC News -  via @ABC   #PoliceThePolice,3,2,5,0.0,121,0,18,18
Dear @SIRIUSXM - you have lost me as a long-time customer as long as you are in bed with Steve Bannon. #cancelled  #getwoke,0,0,0,-0.05,123,0,11,11
. Graphic video shows Daniel Shaver sobbing and begging officer for his life before 2016 shooting  ,0,0,0,0.0,99,0,3,3
"I am afraid the point has come where the vast majority of voters (and probably a higher % of non-voters), even a majority of Democrats, believe the ""system"" is #Rigged @Lawrence and they do not trust #FBI i.e.  Some hate #Trump; Some think it is great he says it.",0,0,0,-0.06999999999999998,263,0,13,13
The banned guns used in this shooting are already illegal so it wouldn?t change anything #toomanynames ,0,0,0,-0.5,103,0,1,1
"Thread for Alabama voters. 
#NoMoore
#DougJonesForSenate
#RoyMooreChildMolester
#NoMoore2017 
#GetOutTheVote

#Resistance ",1,2,3,0.0,129,0,22,22
"Alabama, who will represent you?
If you do not vote, then you've given your voice to those who do vote. And the KKK will be voting. #Moore = KKK
 #BlackTwitter #DougJonesForSenate #ALSenate
#Equality #TheResistance #UniteBlue #GeeksResist ",3,5,8,0.0,242,1,29,30
"Today in Black History, December 8  via @YouTube #blackhistory  #blacktwitter #todayinblackhistory #blackexcellence #melanin",2,2,4,-0.16666666666666666,124,0,6,6
"We have repeatedly seen?literally seen?that you can execute a black man in America with no consequence. 

Yet there?s more outrage at a black man taking a knee than getting murdered. Don?t tell me  as much as others. 

#DanielShaver ",5,3,8,0.09166666666666667,237,0,9,9
"Black and gold #heart choker #necklace. #Handmade 
Makes a great #holiday #gift! 
Sales support  
#etsy #Jewelry #BlackLives #shop #HolidayShopping 

",0,0,0,0.4166666666666667,155,1,12,13
"#StayWoke American Medical System Was Built On Slavery
Black women?s history matters in medicine.  
Video:  ",7,4,11,-0.05555555555555555,110,0,14,14
I just finished The Hate U Give by @angiecthomas. Had it half the year and finally made time to devour it. Beautifully written. Bold. Important. Buy this for the littles in your life and tell them to shine bright like ??. ,29,2,31,0.18809523809523807,222,0,10,10
Black Mothers Keep Dying After Giving Birth. Shalon Irving's Story Explains Why  #women #inequality #POC #Healthcare ,0,0,0,-0.16666666666666666,117,0,19,19
"Why we #TakeAKnee cops are too afraid.  #BLM #trump #AllLivesMatter  #BlueLivesMatter  @NFL @foxandfriends @realDonaldTrump 
Mesa Police shooting: Daniel Shaver seen crawling, begging in disturbing video ",2,0,2,-0.55,205,0,25,25
"Everyone needs to hear this song  

",0,0,0,0.0,38,0,4,4
Make America Great Again #Politics #America #Fire #Hat  #Trump #Antifa #Maga #Flame #Burning... ,0,1,1,0.8,96,0,14,14
That Feeling You Get When You Realize That African Americans REALLY ARE About To Be Free & Have Support From #UNGA #UN To Jumpstart #SustainableDevelopment! #FridayFeeling #Freedom #Dignity #AfricanAmericans   #ItsTimeToThrive #GlobalGoals #ItsTime #TheDecade ,1,1,2,0.2333333333333333,260,1,55,56
"Don't talk about it, Be about it! Congratulations @marclamonthill  #BlackTwitter   @TheRevAl ",0,1,1,0.0,93,1,11,12
I have nothing else to add because @JuliusGoat slam-dunked this. #DanielShaver  ,2,0,2,0.0,80,0,8,8
"Nothing in #America is more horrifying or cruel than white cops killing unarmed black men, and getting acquitted. ",0,0,0,-0.3133333333333333,114,0,5,5
" has a chance in a world of social media ..reality us amnesty and amnesty is reality because immigration through the lens of brown  PEOPLE CAMP BIRTHER T at! HAND IN HAND UP OR DOWN ON THE #DreamActNow @AlabamaFTBL 
@msstate ",0,1,1,-0.056944444444444464,226,1,49,50
I don't care if this is acceptable behaviour for a cop; this is clear abuse of power. Listen to what the cop says; he has every intention to kill regardless if the suspect is an actual threat.  ,0,0,0,0.05000000000000001,194,0,5,5
All the cops' murders of all the unarmed Black and Brown people should receive this much attention/outrage. #FirstTheyCameFor  #NativeLivesMatter ,0,0,0,0.016666666666666673,146,0,13,13
When You Realize That You Don't NEED #Congress To Build/Create A Better Future And A #Modern Society/Civilization!! #FridayFeeling #AfricanAmericans #BLM #AfricanAmerican #BlackTwitter #POC  #BlackCommunity #blackamericansforabetterfuture #BlackAmericans #ItsTime ,0,0,0,0.2708333333333333,264,2,45,47
"Me after watching #JurassicWorldFallenKingdom trailer

""So wypipo a will save dinosaurs but can't say  "" ",0,0,0,0.0,107,0,9,9
"'I had been TREATED LIKE a boy for so long..""boy get over here and do that"" ..I was proud wear the sign the sign I AM A MAN'  #BlackHistory #MLK #RFK #JFK #SaluteToService ",0,0,0,0.375,172,0,37,37
DO YOU EVEN CARE?  ===> @thedemocrats @dnc @cnn @msnbc @mmfa @moveon @dailykos @donlemon @joyannreid @VanJones68 @RepMaxineWaters @maddow @HardballChris @AC360 @joenbc @motherjones  @slate @salon @politico @mediaite @voxdotcom #BlueLivesMatter ,0,0,0,0.0,244,1,28,29
?????? #MAGA well Goldberg O?Donnell and  leader we?re waiting for y?all to LEEEEEEAAAAAAAAAVVVVVVVEEEEEEEEE!!!!!!!!!!!!!!!! ,1,1,2,0.0,125,16,42,58
 my ass ,0,0,0,0.0,8,0,3,3
"well. it is Christmas 
 ",2,0,2,0.0,25,0,4,4
"??? 
#UNTOUCHABLE #Eminem #iloveyouslim #stan #REVIVAL  
#NowPlaying ""Untouchable"" by Eminem in @tidal ",2,0,2,0.0,105,0,26,26
" @ Uptown, Chicago ",0,0,0,0.0,19,0,2,2
"#WhichHillary Don't be fooled by another establishment politician, , apparently not as much as your vote join the revolution #FeelTheBern ",0,0,0,-0.1,138,0,9,9
This is a carriage used by the Netherland Royals..Please look at the drawings on the carriage and say what you see... #Lusaka  ,0,3,3,0.0,127,0,8,8
.  woman was attacked by police dog.  Absolute disregard for her.  Why was dog able to bite her. Do these cops know how to control the dog? What?s going on? We will never trust or believe cops care for or respect black & brown ppl Disappointment daily ? ,0,0,0,-0.013333333333333329,254,2,9,11
"Smh this racist bitch Roy Moore and of course the head of the Klan and super sex predator @realDonaldTrump gonna support him. ""Make America great again"" is really sayin make America white again.  

 ",0,0,0,0.3333333333333333,201,0,12,12
Black Lives Matter   Black Lives Matter  Black Lives Matter  Black Lives Matter Black Lives Matt Black Lives Matter  er Black Lives Matter Black Lives Matter Black Lives Matter Black Lives Matter Black Liv Black Lives Matter  es Matter Black Lives Matter  #BLM,0,1,1,-0.16666666666666666,260,0,45,45
Jury says a black man begging for his life is cause for cops to take his life.   ,0,0,0,-0.16666666666666666,81,0,4,4
"Every day until their murderers are in jail
#JusticeForAlvaBraziel 
#JusticeForAltonSterling
#JusticeForPhilandoCastile 

",8,3,11,-0.1,127,0,16,16
"Watch NYXT for #HumanRightsWeek: our partners are shining a spotlight on , #disability rights, #humantrafficking, anti-#LGBT violence, the prison industrial complex and more now:  #HumanRightsDay ",0,0,0,0.1,196,0,18,18
 get cancer niggers,0,0,0,0.0,19,0,3,3
"EPIX HD: watch 1000?s of BIG movies like Selma Online!  #FreedomFriday
 ",0,0,0,0.0,73,1,16,17
"White Supremacy, y'all; this is Steve King, Rep. Iowa. #MAGA  ",0,1,1,0.0,62,0,13,13
but peep how yo man tried to make a  joke and @chancetherapper euro stepped that hoe ?? ,1,0,1,0.0,88,0,0,0
"Love the #metoo campaign. Men gotta check men. Would love to see it followed by #iWasWrong

But can we get this much solidarity for ",6,2,8,0.4,134,0,9,9
Oppose Thomas Farr For Federal Judge |   ,0,0,0,0.0,41,0,9,9
Where's  to address black males abuse black females? Alex Harrison  via @MailOnline,0,0,0,-0.16666666666666666,83,1,8,9
"
This must stop.

#PoliceBrutality  
#AllLivesMatter 
#BlueLivesMatter",0,0,0,0.0,75,0,12,12
Eminem raps about Black Lives Matter on new track after taking on Donald Trump in new interview - Metro   ,0,0,0,0.03535353535353535,106,0,10,10
HOW AND WHY DOES THIS KEEP HAPPENING!! These judges have no right to sit on a bench if they excuse this behavior. What must we do !? STOP STOP STOP STOP STOP KILLING BLACK PEOPLE  ,0,0,0,-0.12400793650793653,180,4,86,90
Imagine this happening to white ppl over and over and then ppl getting mad that you want to protest. This is why do!  ,1,0,1,-0.390625,118,1,18,19
 Camps At Police Station For 2 Weeks |  ,0,0,0,0.0,40,0,9,9
"EPIX HD: watch 1000?s of BIG movies like Selma Online!  #FreedomFriday
 ",0,0,0,0.0,73,1,16,17
"I still can?t bring myself to watch the video, but um isn?t the guy who was killed white? Where?s the #WhiteLivesMatter crowd? Oh, that?s right, #whitelives only matter when black folks are demanding that . You see how that works? ? ",1,0,1,-0.01619047619047619,233,3,7,10
This is what black privilege looks like.   #ItsOkToBeWhite #America ,2,1,3,-0.16666666666666666,68,0,10,10
"So can you see the problem NOW people...? No #Justice for #DanielShaver either.  (bcos, as we always have to point out, only @Blklivesmatter seems to speak up, regardless of race of victim - I must have missed the outcry from all the ALLLives folks on this one... ",1,1,2,-0.037500000000000006,264,1,17,18
You survival guide for a #chimpout.   #BlackTwitter # ,2,2,4,0.0,54,0,6,6
"For all the #trumpsuporters that follow me I hope that you pay attention to this video about the man who was executed and if you have any type of conscience, then you would support  and you would support the NFL players that kneel. ",0,0,0,0.0,232,0,5,5
Hey  Look's like your entire narrative on cops killing only blacks is considered debunked now. Look's like the whole #AllLivesMatter protest was never a counter protest to begin with. ,0,0,0,0.06666666666666668,184,0,9,9
"May that murderous filth get his comeuppance soon.
 ",0,0,0,0.0,53,0,4,4
"When You Realize That African American #Liberation #Freedom #SustainableDevelopment IS On The Horizon!  LITERALLY, Imagining A Future Full Of REAL #HumanRights #Possibilities #Direction And #Dignity! #FridayFeeling #AfricanAmericans  #ItsTime #RiseNOW #TheDecade ",0,0,0,0.12,263,2,54,56
Finally  ,0,0,0,0.0,9,0,2,2
The most hated non-politicans of 2016 ??#Formation #TakeTheKnee  ,1,0,1,-0.2,65,0,8,8
"This is how Israel treats Palestinian boys.
Remember: This is inside Palestine, NOT Israel.
#Jerusalem #Palestine #Israel  #MeToo Pensacola ",3,0,3,0.0,142,0,19,19
This is the problem with the  movement. It isn't about race it is about police brutality. Because they frame it as a racial issue they are losing. If they focused on the diverse group of people who have been killed in this way there would be change. ,0,0,0,-0.2,250,0,7,7
"Veganism is having a renaissance among black Americans, driven in part by , docs like @wthfilm & connecting personal health/animal welfare/#socialjustice w/ the fight for racial equality:  via @nytimes pic: @sweetpotatosoul #blackvegansrock ",1,1,2,-0.08333333333333333,241,0,5,5
Unarmed cop killing. #ACAB #JeanPedroPierre   ,0,0,0,0.0,46,0,11,11
Die die die all you killer cops and judges  ,1,0,1,0.0,44,0,4,4
"?????

This video is absolutely sick. My heart breaks for #DanielShaver and his family. I hope that cop is never put on any other force again, he is a literal psychopath. 

 ",1,0,1,-0.4196428571428572,178,0,8,8
Should've been called  Eminem - Untouchable (Audio)  via @YouTube,0,0,0,0.0,65,0,9,9
"It's great that ""Trump-Russia"" has allowed so many to see the dangers of foreign influence over the U.S. government and take a stand for sovereignty and nationalism. Bravo! ??? #resistance #resist #defy #occupy #BLM ",0,0,0,0.38125,216,1,12,13
Alright #AllLivesMatters crowd?come with the same energy y?all have when you?re railing against . ,0,0,0,0.0,98,0,7,7
UPDATE: Killer Cop Sentenced 19 Years #WalterScott  #PoliceState #PoliceBrutality @TheJusticeDept ,0,0,0,0.0,98,0,22,22
"Watching Americas Evil, Racist Regime #Congress #potus etc. Go Down In Flames, As We Rise Like The #Phoenix From Those Flames!!! #FridayFeeling #HumanRights #HumanRights4All #AfricanAmericans  #AfricanDiaspora #TakeAKnee #StandUp4HumanRights #FightRacism #ItsTime ",1,0,1,-0.6519097222222222,264,3,44,47
 to my boy too ,0,0,0,0.0,15,0,2,2
Eminem raps about Black Lives Matter on new track after taking on Donald Trump in new interview - Metro   ,0,1,1,0.03535353535353535,106,0,10,10
In which amazon gets me on  their side     ,0,0,0,0.0,43,0,4,4
"#Dem politicians represent the Majority of working TAX paying Americans, yet roll over & let RW Nazis & GOP scammers loot the Bank. #RISE ",0,0,0,0.0,138,0,20,20
I'm angry that POC can't live without fear. ,0,0,0,-0.18181818181818185,44,0,7,7
#Dem politicians represent non White ppl AND the Electoral majority. but do Nothing but lie down to the rolling fascist racist stomp of RW Nazis thru Our Congress. #RISE ,1,1,2,-0.07777777777777779,170,0,19,19
"What are they resisting.??
#Resist #NotMyPresident #StillWithHer #Antifa  ",2,3,5,0.0,75,2,12,14
"New book exploring the past, present & future of the N-Word.    #nword #socialjustice #NWORDCAROL ",0,0,0,-0.02840909090909091,98,0,13,13
What factors complete your confidence??  @Butta_Blog @USBloggerRT @bloggersoc @wetweetblogs #BlackTwitter  #melaninmagic #FRIDAY #FridayReads #browngirlbloggers #BloggingGals #lifestyleblog #LifestyleBlogger #confidence #selfesteem,0,2,2,0.1,231,0,25,25
#FridayFeeling #HumanRights4All #GirlPower TURNS INTO #WomanPower TURNS INTO #WomenPower  #Freedom Freedom - International Day of the Girl  via @YouTube,1,0,1,0.0,152,0,39,39
"?WARNING?GRAPHIC CONTENT?

This happens to dozens of unarmed black men EVERY YEAR. 

THIS is why the  mat is imp & why #TakeTheKnee matters!

*I* couldn?t understand cop?s instructions while watching- imagine trying to in that moment. T-laden untrained ? ",0,0,0,-0.2083333333333333,261,1,43,44
Na Black People Can We Talk About The Fact That The Son Of a Bitch Who Brutally Murdered Walter Scott As He Ran Away Got 20 Years In Jail. The South Dont Play About That Shit Boyyy If Only These Other Fucking States Would Take Notes ,0,0,0,-0.29523809523809524,233,0,60,60
"An ex-cop from Arizona was acquitted for shooting an unarmed, sobbing man


#TakeAKnee ",0,0,0,0.0,90,0,8,8
 get covered. ,0,0,0,0.0,14,0,3,3
"Hey Twiiter- #HopeWiseman will be the 1st Black Owner of a #CannabisDispensary in Prince George?s County, #Maryland @TheRevAl @ShaunKing @NAACP @SnoopDogg  Catch her on  #WagsAtlanta  Read more here... #BlackTwitter  ",2,1,3,0.16666666666666669,217,0,33,33
" This proves that Fred Hampton Was a leader and a Icon of civil rights he was Pioneer and trailblazer ""I am a revolutionary ""   #R.I.P.FREDHAMPTON",0,0,0,0.3,146,0,37,37
"EPIX HD: watch 1000?s of BIG movies like Selma Online!  
 ",0,0,0,0.0,59,1,14,15
the president of the #SCLC joining and leading the demand for #JackieLacey prosecute killer cops  #BoyleHeights #Chicano Power ,1,0,1,0.0,127,0,13,13
"Say their name. Jerry Michael Graham Jr., 2015-10-28 .",0,0,0,0.0,54,0,8,8
"MUSIC TO MY EARS: I'd LOVE to see African Americans  #NAACP lead and  BOO Trump off the stage tomorrow #CivilRights . DO BOO and VOTE! #DougJones  #MeToo #TheResistance   #racism #repJohnLewis #Mississippi #NationalUrbanLeague #NationalAccionnetwork, #Dems  #vote",0,1,1,0.25,263,1,58,59
 2017 and beyond,0,0,0,0.0,16,0,3,3
If you are in Mississippi please show up to protest Trumps A parents at civil rights museum. Peacefully turn your back to this racist.  #JohnLewis #NotMyPresident #Civil rightsMuseum,0,2,2,0.125,182,0,15,15
.One of many despicable truths.  Why we must always demand Respect &Justice.  @ava ??@HISTORY @HistoryToday @blackvoices @hrw ??@NYCSchools @TheJusticeDept @ACLU @BLACKGIRLSROCK #KaliefBrowder #PhilandoCastile #CentralParkFive ?? ,0,0,0,0.5,230,0,48,48
"#CNN @CNN @OutFrontCNN Yo @KateBolduan these trump streams are about to get straight demolished by trolls.  #resist #occupy  #ImpeachTrump #AlabamaSenateRace 

",0,0,0,0.2,162,0,22,22
White people don't even care about this man's life! It's  that are outraged over his murder! #DanielShaver their dumb hashtag was a sham and we all knew it!,2,0,2,-0.40625,156,3,7,10
Hundreds of Palestinians hurt as IDF use tear gas on them #zionism #Israel #WarCrimes #apartheid @UN #censorship #BoycottIsrael #BDS  #empire #USMilitary #tpot #tdot #tcot #maddow #cnn ,0,0,0,0.0,185,0,21,21
"He wanted to do more than harm him, he wanted to kill him, this is why you can't trust cops especially white cops.   ",4,0,4,0.25,117,0,4,4
 watch this video its very good #ResistanceIsImportant #DressUpTheMovies #ThingsITrustMorethanCNN #FaZeUp #Lilpeep #2pac #gta #sanandreas #cj #eazye #tupac #realmuthaphuckkings  #NationalBrownieDay #DonaldTrump eat shit #retweet #followme,3,2,5,0.355,238,0,23,23
"Think the  movement is unnecessary?

You are wrong. #cops ",2,1,3,-0.45,60,1,5,6
Occupy New England Town Crier is out!  #netneutrality ,1,0,1,0.17045454545454544,54,1,5,6
"Umm... America, we have a f**king problem here. This undoubtedly the same kind of person who has not one clue why  is a thing. ",0,1,1,0.3,127,0,6,6
Attention  ,1,1,2,0.0,11,0,4,4
"Boston Herald! IF YOU ARE LEAVING...FOR YOUR LAST STORY, HOST MY STORY!
AS ALL LIVES MATTER AUTHOR & #IPO INCLUDING 
 #BLM WLM BLLM RLM..ETC, 
I WISH U WELL!  PLEASE STATE MY TRUTH~ #AllRightsReserved THESE ARE HOLY,
BUT DEMS STOLE THE MORAL AUTHORITY WITH #SOROS",0,0,0,0.0,267,3,191,194
"AND, @jeffsessions won't be skimming off the penalties collected to hand over to radical American hating leftwing terrorist orgs
@MoveOn #LaRaza #RevCom #CPUSA  ",0,0,0,0.0,162,0,18,18
Eminem raps about Black Lives Matter on new track after taking on Donald Trump in new interview - Metro   ,0,0,0,0.03535353535353535,106,0,10,10
My Echo has been politicized ,1,0,1,0.0,29,0,5,5
Live: Yemenis hold huge rally in Sana'a to express support for #Palestine #apartheid #Israel #WarCrimes #genocide #Yemen #maddow #tpot  #tdot #tcot @StateDept @UN #Saudi #USMilitary  #msnbc #cnn #abc #nytimes,0,0,0,0.2681818181818182,208,0,19,19
"This fucker shot man in the back, & then planted a tazer on him to deny him  justice.
Thank God for the video.
I hope this Fuck spends the next 20 years getting his ass kicked in prison, then dies on his last day, choking on a fat dick..
#WalterScott   ",105,31,136,-0.1,256,0,10,10
this is a track of a generation!   #BlackPanthers #Rap #gym,0,0,0,0.0,59,1,3,4
"City offers $31 million to settle Englewood Four's wrongful conviction:  | Among cops sued was former detective Ken Boudreau, who has an extensive history of abuse and coercion of confessions. He was literally Jon #Burge's disciple. ",1,4,5,0.03333333333333333,233,0,12,12
" For the 8 millionth fucking time - The cops are not there to play games. IF you don't comply, fuck with them, attack them or make fast movements, you'll be attracting flies when EMS shows up.  #BlackTwitter #ThinBlueline #TCOT #SJW",4,3,7,-0.26666666666666666,232,0,21,21
"Now imagine if he was black. Trump would be calling for his head. 

This is why #Kaepernik  kneels.
This is why  .
This is why #White Privilege is a thing. ",1,0,1,-0.08333333333333333,160,0,11,11
"This post is to highlight and support my friend @chinezexo, a fellow talented graphic artist I got to meet at the #ColumbusArtsFestival this year. Thanks for delivering the artwork I ordered! ???  #ArtistLivesMatter #ArtistsUnited ",0,1,1,0.31666666666666665,231,1,15,16
"#TheResistance
 
#TrumpRussia
#SteeleDossier
Be sure to readjust your dvr recordings of #TRMS for @maddow @ 9pm.
I ck'd my scheduled recordings #maddow wasn't on list bcz Tonight's TRMS' #SteeleDossier-1yr in the making #SpecialReport
#MustSeeTV
#TheMoreYouKnow",36,20,56,0.5,268,0,32,32
"Hey , this is police brutality! A young white man shot to death by an abusive officer as he sobs and begs for his life. This officer was acquitted for this murder. Heartbreaking! (WARNING: GRAPHIC CONTENT) ",0,0,0,0.03333333333333333,206,2,28,30
while you sleep Avalanche grinds and puts in work!   #kotd,0,0,0,0.0,58,1,4,5
"You can also support @PowerDignity just by shopping on AmazonSmile. At no cost to you and no cost to us you can designate DPN as your AmazonSmile charity 

If you utilize Amazon, please take advantage of this:

 

",1,0,1,0.0,220,0,13,13
New DA #LarryKrasner down w  Funded by #Soros in the City of Brotherly Violence #Philadelphia along w #KimFoxx they will turn the city into another #Detroit or #Chicago Wasteland! #BlackViolence has already ruined most of it!  via @YouTube ,1,2,3,0.18897306397306396,240,2,23,25
My Heart Goes Out To The Family Of #DanielShaver. I Believe  Got To Shine As Much Light On That Fatality As I?t Does The 100?s Of Black Men Murdered By Power Tripping White Policemen.,1,0,1,0.07777777777777779,183,0,37,37
" @ Bellingham, Washington ",0,0,0,0.0,26,0,2,2
"""Food justice is racial justice."" #foodsecurity #nutrition #publichealth  #incomeinequality #socialjustice ",0,0,0,0.0,107,0,4,4
Why are we still pretending that  movement + #Kaepernick are in the interest of black people ??? (tyrese voice) ,0,0,0,-0.16666666666666666,112,0,5,5
"Ok so - I feel really bad about that drunk white guy that died in the hotel hallway because I know what?s really going on here. Evenstill, Murcia: ",0,0,0,-0.09999999999999996,147,0,8,8
"These @SacPolice murdered #DaxionFlenaugh yet still work beats in Sacramento. 

Officers Jefferey Todd Carr, Dustin Southward, Eric Toomey

",17,12,29,0.0,144,0,17,17
The butthurt is strong in this one. Happy Friday!!  ,0,0,0,0.7166666666666667,52,2,6,8
Eminem raps about Black Lives Matter on new track after taking on Donald Trump in new interview - Metro   ,0,0,0,0.03535353535353535,106,0,10,10
"Outcry After Roy Moore Told a Black Man That America Was Great During Slavery- Get mad Americans, this is not who we want to be, nor what we?ll accept.  #NoMoore #NoMooreTrump #KKKillerGOP #NazisInTheWhiteHouse #POC  #StrongerTogether  ",0,0,0,0.002777777777777805,236,0,39,39
The growing ties between  and Palestine - Mondoweiss ,0,0,0,0.0,53,0,6,6
"I thought black lives matter from the 504 loves roger goodell !?! 
""BLACK LIVES MATTER SAINTS FANS"" ARE NOW CALLING OUT GOODELL & THE REFS. HYPOCRITES!!!! ????

  #NOLA #SaintsFans #TakeEmDownNOLA",0,0,0,-0.33365885416666663,199,7,81,88
"I wonder how  will respond to a lower middle class unarmed white male being murdered by cops who weren't convincted for this ... despite it being on camera. Seems his so-called #whiteprivilege  couldn't save him?

#BLM #PoliceBrutality ",0,0,0,0.0,238,1,10,11
 HELPS US #BOYCOTTTVONE @TVONE ABOUT CANCELING THE ONLY BLACK NEWS SHOW WE HAVE.,0,0,0,-0.08333333333333333,80,0,67,67
"White people and the willfully ignorant, this is why we say . While the majority of these injustices happen to us, make no mistake the corrupt police institution knows no bounds and this is as tragic as the other injustices. My heart breaks for this family. ",0,0,0,-0.34375,258,0,6,6
"For those of you idiots that are confused...
 
Has been there... where the fuk were you? 
#DanielShaver",0,0,0,-0.6000000000000001,106,1,7,8
"Look at this nonsense #ItsOkayToBeWhite? I feel like it?s a setup, could snowball into something else that  wants no part of.? what could that be?? #Newslaves",0,0,0,0.2,158,3,11,14
What?s wrong with black Christmas  ,11,4,15,-0.3333333333333333,35,0,5,5
"I'm all for @endgenocide -in fact all I'm doing in last year is trying to @GenocideReport for @CPG_USHMM & The Public. We have right to know reality, #facts @antonioguterres @UNhumansecurity @UNHumanRights @UN_PGA #WhatsUpLagos  #Africa2017 #MoveOn #FreeBiafra ",1,14,15,0.09523809523809523,261,0,37,37
"This is unbelievable! Honestly, I believe we  supporters should March for this man as he was brutally executed by a cop while begging for his life! Scumbag cop acquitted! Watch the footage! ",1,0,1,-0.2375,190,4,9,13
"Four judges' failure to understand what coercion is, even with a video recording and as brilliantly explained by devoted advocates (@LauraNirider and @SDrizin), underscores how far  and #MeToo and all campaigns for autonomy have to go. ",4,4,8,0.2277777777777777,236,0,10,10
"The 'it's ok to be white' thing is so pointless. of course, it is!? it always has been !? Why do whites want to feel oppressed so badly? it's not a good feeling to be oppressed??!?  ",0,0,0,-0.08203125,182,9,2,11
"White unarmed father of 2 assassinated by Gun happy cop.
 So goes the Blackman, so goes America, Everything you do to us always ends up making its way to the suburbs ",0,0,0,0.4,167,0,9,9
This is another reason why  is relevant here  via @torontostar,0,0,0,0.4,62,0,2,2
And it should be seen by every citizen of the United States.  ,1,1,2,0.0,62,0,6,6
"Michael Slager found guilty but what about:
Betty Shelby 
Timothy Loehmann
Jason Van Dyke
Howie Lake
Blane Salamoni
Jeronimo Yanez
Robert Rialmo 
Daniel Pantaleo
And all the other scary ? that executed innocent lives out of fear and pure evilness 

",1,0,1,-0.08214285714285714,260,0,23,23
Had fun with my brother in #NYC #WestVillage today! #Aminah #Mixed #MixedFamilies #MixedGeneration #AdventuresInTheBigApple #Fun #WashingtonSquarePark  #BlackIsBeautiful #BlackGirlMagic #Family #Love #RaiderNation ,0,0,0,0.29375,214,1,34,35
We won't be lectured given that we don't treat our own citizens equally maybe we shouldn't be lecturing anyone! #Equality #EqualRights  #humanrights #MeTooMovement #WomensRights ,0,0,0,0.3,178,1,12,13
 Alicia Garza Interview With Melissa Harris Perry ,0,0,0,0.0,50,0,10,10
"#AlexaIsWoke...I asked her about Black Lives Matter. Needless to say, I'm keeping her ?  #Amazon #Alexa ",11,5,16,-0.3333333333333333,104,0,14,14
"I support good policing, this is NOT good policing. This a travesty, of justice, to the police and to society as hold. We must all, work to put an end to these incidents. This is real, this why we have  ? ",0,0,0,0.18333333333333332,205,0,10,10
All Honor To The Ancestors Who Struggled Through the Pain & The Blood To #RISE. We Will Only Go FORWARD.  ,1,4,5,0.0,106,0,30,30
Liberate Our Brothers And Sisters From The Slavery that Is Mass Incarceration.  #LIFT #RISE ,3,5,8,0.0,92,0,22,22
We Embrace More REAL American Values Than America Ever Has. Embrace Your Wisdom. #RISE #LIFT  ,1,0,1,0.25,94,0,27,27
Eminem raps about Black Lives Matter on new track after taking on Donald Trump in new interview - Metro   ,1,1,2,0.03535353535353535,106,0,10,10
"Dear Australia, I admire the fact that you finally, after so many centuries, legalized gay marriage. However, y?all really need to deal with the racism that lies within your country. For real. It?s fucked up. #LGBTQ ",0,0,0,0.04333333333333336,216,0,14,14
"Diversity isn?t *a* Strength, ?s it?s our GREATEST strength, @SteveKingIA. But trolls from hell such as yourself continue to be political perverts. People like you are a STAIN ON THE AMERICAN FLAG. RESIGN YOU RACIST PIG.    #DREAMers #transrightsarehumanrights",1,0,1,0.25,260,0,64,64
More Americans than ever are woke and seeing the systematic racism against an entire race. Our brothers and sister of Red White and Blue. People are seeing the corrupt #KKKillerGOP for what it is. #NazisInTheWhiteHouse #Slavery #ModernSlavery  ,2,1,3,0.0,244,0,24,24
"Can we talk about this? White woman are at the forefront for the #metoo campaign, but fail to recognize their role when it comes to the wrongful sexual assualt convictions towards black men. ?
#BlackTwitter  #blackmen ",2,0,2,-0.04166666666666666,219,1,7,8
"After NatTurner
Negro succumbed to worship
his master's God
But #Freedom is evil as
You do not die for it
You kill for it!
",0,0,0,-1.0,129,1,12,13
Text ?resist? to ?50409?.   ,1,0,1,0.0,28,0,4,4
Checkout my work in the  I AM SAN FRANCISCO Exhibition at @SFSU Art Gallery in the Cesar Chavez building! #SanFrancisco #photography #art #stories  #AfricanAmerican ,1,0,1,0.0,165,1,32,33
"#Alexa says 
#Conservatives lose their shit.
Go ahead. Throw your #Echo out a window. Film it.
",0,0,0,-0.2,98,0,9,9
"Being called ?ni**a? by some random white guy over social media that I don?t even know actually humours me with the concept that some people have of how equal our society is. 

We will never stop until hate does  #bamewithoutshame",9,3,12,-0.2111111111111111,232,0,3,3
" misses the point: The police problem in America is the caliber of individuals who join the police, and the power of life and death they exercise arbitrarily -- and in this case capriciously -- over innocent citizens. ",1,0,1,0.2,218,0,5,5
"Your rights -Know them ?
Your rights- Are in this box ?
Your rights- Are my rights too ?? ..... STOP ARGUING! Yes they do! ",1,0,1,0.0,125,2,21,23
I have had enough of the same story being told by cops ?he had a gun? or ?he was reaching into his coat?. BULL SH*T. Those cops gunned them down for no reason. They were human beings. INNOCENT HUMAN BEINGS ,2,1,3,0.057407407407407414,206,0,31,31
Are you battling with your confidence??  #BlackTwitter  #WOC #melaninbloggers #blackswhoblog #blackwomen #BlackWomenLead #BlackWomenAtWork #melaninmagic #HBCU #hbcus #BlackGirlMagic #BlackBoyJoy #afro #AfroFeed #FridayReads #FRIDAY,0,0,0,0.0,231,0,36,36
Impeach Trump: Add Your Name -  #afronews #blacktalkradio #blacknews ,2,2,4,0.0,69,0,7,7
"for all of you who rolled your eyes at what i said today during the assembly: i respect you and your decision to not agree with me. but i leave you with this question, if you preach to accept others, then why do you have such a hard time accepting others?  ",4,1,5,-0.14583333333333334,257,1,3,4
"Alabama:  Be on the side of the four little #angels and vote for #DougJonesForSenate.

#FridayFeeling #UniteBlue #ALSen  ",1,1,2,-0.1875,123,0,16,16
We will never forget or stop fighting for change #SocialJustice  #woke ,0,0,0,0.0,71,0,3,3
"I have no words only tears of anger-I'm terrified for my brothers & sisters' very LIVES in this white supremacy's successful #CoupIfUSgovt @ EVERY level of law enforcement+judiciary
#DOJ #Sessions #Trump
 
#TrumpIsWhiteSupremacy
#FinalSolution
#TheCullIsInProcess ",5,4,9,0.2375,269,0,35,35
"WTF? I ordered a simple coffee maker for my parents for Christmas, and it shows up f'n RACIST! How is this happening? White supremacy is everywhere.  #JusticeforTrayvon #NoMoreRacism #WhiteSupremacy #FridayFeeling #ThisIsNotOkay #MeToo ",2,0,2,-0.16666666666666666,236,3,31,34
"Race, Class, & The Revolt of the Black Athlete  #TakeAKnee #ColinKaepernick #ImWithKap  #NBA #NFL #WNBA #1u",7,7,14,-0.16666666666666666,107,0,27,27
Everyone really needs to learn that . ITS A FACT.,2,0,2,0.2,49,0,11,11
"Try this with others. ?Alexa, James Baldwin says.? ?Alexa, what does Maya Angelou say.? 

#TrumpVoters have no idea what?s in their homes. And what?s in their homes knows it. ",0,0,0,0.0,177,0,13,13
"#KthalpShow listeners: interview w/ @es_snipes Erica Garner, a  & anti-police brutality organizer,  whose father Eric Garner was murdered by #NYPD is dropping soon. @Josmar_Trujillo, I'd love to interview you about Ramsey Orta.",16,4,20,0.5,227,0,17,17
Carjacking Suspect Killed by S.F. Police in Bayview Was Apparently Unarmed  #KeitaONeill ,0,0,0,-0.07500000000000001,89,0,16,16
"Any faith I had in American Justice just evaporated with this video. There is absolutely no way to justify a 'not guilty' verdict with this, I don't care how you spin it. Consider me radicalized.

#PoliceState
#OccupyingArmy 
#PoliceBrutality  ",0,0,0,0.05,248,0,16,16
"Black lives matter to Alexa and to me.
 ",1,0,1,-0.16666666666666666,41,0,5,5
"?Please be aware that sign clutter can be a nuisance to your neighbors."" #RolandPark community association on  &  pro-immigration signs. 

...NAH, you're just uncomfortable w/daily reminders of injustice & #WhiteSupremacy. ",1,0,1,-0.125,225,0,11,11
White People Are Upset That Amazon's Alexa Believes Black Lives Matter - The Root   ,0,0,0,-0.08333333333333333,84,0,16,16
Eminem raps about Black Lives Matter on new track after taking on Donald Trump in new interview - Metro   ,0,0,0,0.03535353535353535,106,0,10,10
Michael Slanger?s conviction is a heartening example of accountability ? and a sign of how far we have to go. #PoliceReform #EndPoliceBrutality  ,3,2,5,0.1,145,0,10,10
Going to be point Blank Obama would have been Impeached if he had 1 Sexual Assault accuser. #BlackCaucus  #resist @RepMaxineWaters @repjohnlewis #WomensMarch  But Trump is White. Hypocrisy and Still no Rebuttals @POTUS44,1,1,2,0.16666666666666666,220,0,24,24
Could someone with  make some bacon out of the #Pig who killed #DanielShaver. #NoJusticeNoPeace doesn't just apply to Black folks.,2,1,3,-0.18333333333333332,130,0,12,12
This right here is why I support  ,0,0,0,0.2857142857142857,34,0,6,6
Cop FINALLY Goes to Jail for Murder of Walter Scott (Video)  via @thornycroftdia #WalterScott #policeshootings  #blm,0,0,0,-0.05,116,0,16,16
The Hate You Give by @angiecthomas was a spectacular read. I lowkey teared up in some chapters. Amazing job Ms. Thomas ?? ,0,0,0,0.13333333333333333,122,0,11,11
"12/8/80 Our ? lost #JohnLennon - but we can still IMAGINE with him ??
Imagine all the people living for today
Imagine all the people living life in peace
Imagine all the people sharing all the world
. . . the world will be as one
#LGBTQ  #TransEquality #trans ",5,2,7,0.0,265,0,23,23
White people are upset that Amazon's Alexa believes .  by #OccupyWallStNYC via @c0nvey ,0,0,0,0.0,87,0,12,12
Heartbreaking.   in medical treatment as well. ,0,0,0,0.0,47,0,4,4
"Wounded Baton Rouge Cop Sues , Deray McKesson - Long Room ",0,0,0,-0.05,58,0,13,13
"Blacks kill blacks at 10x the rate of whites
35x the rate of Jews.
We rob our own lives of value. 
Make ",1,1,2,0.6,107,0,7,7
"#racizm101 #racism  #BLM 

When I see the tiki torch, khaki pants, #maga, no girlfriends #racist. I think of the word of the late great #BernieMack 

",1,0,1,0.25,154,0,11,11
"White officer murders #MagdielSanchez, a deaf man, outside of his OKC home for not following orders BECAUSE HE WAS DEAF. Oklahoma PD CONTINUES its killing of POC like deers in the street, @CivilRights not gonna do shit under Sessions of course. ?  ",26,23,49,-0.05,248,0,43,43
Teaching him early! ??#BlackPower  #FatherToAmier ,83,18,101,0.125,50,1,9,10
" Action
TODAY FRIDAY DEC 8th at 4PM 
210 W. Temple (Spring St. steps). Demand that DA Jackie Lacey prosecute police who kill our people or RESIGN. Stand with the families who lost loved ones, show them we as a community care and stand in solidarity! @BLMLA ",0,0,0,0.4875,259,1,41,42
"At SF Bayview town hall meeting, anger erupts as police show footage of an unarmed man   #killercops #policeimpunity ",0,0,0,-0.7,117,0,7,7
"EPIX HD: watch 1000?s of BIG movies like Selma Online!  #FreedomFriday
 ",0,0,0,0.0,73,1,16,17
Erica Garner endorsement of Bernie Sanders for President  #EricaGarner #EricGarner  #BernieSanders,0,0,0,0.0,98,0,14,14
"I bet if Congressman Conyers district was mostly 
WHITE
it would not take 11 months to fill!


#Detroit @RepDanKildee @RepLawrence @RepDebDingell 
@indivisibleDTW ",0,0,0,0.0,169,1,23,24
"This shooting proves two things:

1) Training officers on how to control the situation NEEDS TO CHANGE. An unarmed man should not have suffered the fate of #DanielShaver.
2) ""All Lives Matter"" TRULY IS A RACIST REBUTTAL FOR . Where are you all regarding this? ",1,1,2,0.3,263,1,50,51
"InterVarsity Answers Why  Was Included, but Pro-Life Group Was Not, at Urbana '15 ",0,0,0,0.0,82,0,15,15
": Alicia Garza on privilege, justice and founding a movement - Metro Weekly ",0,0,0,0.0,76,0,7,7
"That Misogynist, racist low IQ president, don't you just hate this! #MAGA #IStandWithMyPresident @realDonaldTrump @Rightwingmadman @bluelivesmtr @RealJamesWoods @NatPoliceAssoc @wolfgangfaustX @Kaepernick7 #ShaunKing #blueracism  #BlueLivesMatter ",21,10,31,-0.5,247,1,45,46
Williamsville church's 'Black Lives Matter' sign vandalized | WBFO - WBFO   ,0,0,0,-0.16666666666666666,76,0,15,15
"I'll take a knee with #ColinKaepernick anytime. 

Imagine #LiarInChief telling Americans that they should be fired if they exercise their First Amendment right to protest. Fascism is taking hold.

#DumpTrump #25thAmendmentNow #SaveOurHeritage #resistfascism ",292,133,425,0.26785714285714285,262,0,21,21
One thing the @gop had made clear is that racism is still deeply ingrained and supported in America. My apologies to the black community for believing otherwise. ,2,0,2,-0.022222222222222213,162,0,6,6
Unarmed citizens who die at the hands of the police rarely see justice. Glad to see justice served here. #WalterScott #BLM  ,1,0,1,0.4,124,0,10,10
 Police shot an unarmed man because they thought he was burglarizing his own car  via @thinkprogress,0,0,0,0.6,100,0,4,4
Attention #Android users! Our app is officially available for download on the google play store! Make sure download and #KnowYourRights! #legalequalizer #thelegalappofchoice #mobileapp #law #lawyer #SocialJustice ,1,1,2,0.5625,213,3,12,15
"Don?t let them forget!

@SacPolice busted down Zityrua?s door after slamming her to the ground. 

She was pregnant. 

Her neighbors had to help her instal a new door. 

SacPD: ?wrong house?

 
#Justice4Zityrua ",84,56,140,-0.046464646464646486,221,1,14,15
White people are upset that Amazon's Alexa believes .  ,12,7,19,0.0,55,0,6,6
#blackgirlmagic #BlackInkChi #BlackTwitter community #BlackTwitter #INDIGENOUS #mexicansbelike  #MississippiCivilRightsMuseum #iuic #Mississippi? #Mississippistate #blackmen #BlackWomen #law #judge ,1,0,1,0.0,198,0,28,28
Yo.... @eminem emenemis going hard. This joint was more like a disertation in rant form. What's your thoughts??? #untouchable  #takeaknee #kaepernick #alifecypher #FridayFeeling,1,0,1,0.10416666666666666,177,3,5,8
"Former South Carolina police officer Michael Slager was sentenced to 20 years for killing Walter Scott, an unarmed Black man. 

This is what the executive director of @ACLU_SC had to say.  ",532,175,707,-0.08333333333333333,191,0,18,18
The  movement has been proclaiming ?Fuck the Oscars? for a while now. #thegameawards,0,1,1,-0.4,84,0,6,6
"'Please don't kill me': Police officer cleared of murder after shooting a sobbing man as he crawled along a hotel corridor.

#resist #PoliceBrutality   ",0,0,0,0.0,154,0,7,7
"Dear white people, thanks for let black people go to in your universities / colleges . Colleges is paid with white people tax money while we black people receive subsidies and; not pay tax or / and work.  @meketaton_  @BLMLA",0,0,0,-0.026666666666666658,224,0,10,10
Just another liberal racist  ,0,0,0,0.0,29,0,4,4
"?Accidental Filmmaker,? Darnell Lamont Walker, Discusses Black Mental Illness & Leaving America In The Wake Of Trump

#SeekingAsylum #OutsideTheHouse #BlackMentalHealthMatters 

",4,0,4,-0.13333333333333333,182,0,28,28
Remembering #PhilandoCastile on @prayingbaldwin today.  #jamesbaldwin ,5,3,8,0.0,70,0,6,6
When these ASSHOLES are going to stop!!?  #nojusticenopeace ,1,0,1,0.0,60,3,12,15
Where's the #whitelivesmatter matter crowd now? Because the  crew has been pushing this story even though this man is white. Fuck you racists. ,0,0,0,-0.2,143,1,6,7
It's almost as if  had a point about trigger-happy bad cops and the justice system that keeps letting them off the hook or something ? ,0,0,0,-0.6999999999999998,135,0,4,4
Have you heard ?Take A Knee? by Lorde Sanctus on  ,1,0,1,0.0,50,0,9,9
"How many times did Trump tweet about a Mexican immigrant's acquittal for murder of white woman Kathryn Steinle in San Francisco? 

How many times will Trump tweet about the acquittal of a white cop for the murder of Daniel Shaver? 

 #TakeAKnee #DanielShaver ",3,1,4,0.2,263,2,19,21
I think someone should find this cop and give him a taste of his own medicine. In 2016 this is a fucking ABUSE OF POWER. Police swear to SERVE AND PROTECT.  This is MURDER PERIOD. This man belongs behind bars. Or with a bullet in him. Fucking piece of shit.  ,1,1,2,-0.24,259,0,49,49
"Quite often I feel if Black/Brown lives were as reputable in the white community as animal's are, there'd be no cause for complaint...? ",0,0,0,0.25,136,0,7,7
#PhillipBrailsford fuck blue lives matter you bunch of white supremacist mother fuckers  #DanielShaver,2,0,2,-0.13333333333333333,102,0,7,7
And this is why #TakeAKnee and  exist... ,0,0,0,0.0,41,0,7,7
"This was an execution. This cop was a terrorist. This cop was just found not guilty in court.

This is why  exists. This is why Colin Kaepernick knelt. This is wrong. ",0,0,0,-0.125,169,0,11,11
Obviously @POTUS agreed that  ..... Time you pitch in and make a real difference! #Resist will only hold back your potential & bring strife & turmoil. Help to #MAGA because #AllLivesMatter ???? ,1,1,2,0.05,194,1,19,20
ANTISEMITIC NAZI RACIST LITERALLY HITLER #MAGA #DrainTheSwamp #Resistance  #WhiteLivesMatter #LiveMatters @realDonaldTrump @Realjmannarino @VeteransGo @RedPillBlack @RedNationRising @BasedMonitored ,3,1,4,0.0,198,0,65,65
Bend Your Knee  via @YouTube New protest song from Terry Abrahamson and Derrick Procell. Please share! #ColinKaepernick  #FreeSpeech #NFLProtest #ProtestSong #NoDisrespect #PoliticalFootball,0,0,0,0.17045454545454544,190,1,28,29
"When Black women speak, LISTEN. 

 #BlackGirlMagic ",4,1,5,-0.16666666666666666,53,0,14,14
"We will never forget you, but we miss you so much and we will continue to support our   and Freedom March

#USA #American ##racism #MeToo #blackish ",5,2,7,0.1,150,0,12,12
Look at the Blacklivesmatter ting on Yonge Street few years back ???...all the good girls left with a bad bitch ..yea ,0,0,0,-0.03999999999999998,118,0,7,7
"If you are a white person and wondering what  is about 

you. are. an. asshole ",47,20,67,0.0,81,0,4,4
"Beyoncé Surprises Colin Kaepernick To Present Him With Muhammad Ali Legacy Award!
#Beyonce #Kaepernick #ImWithKap #Bey #MuhammedAli #Beyoncé #BlackExcellence #BlackTwitter  ",335,102,437,0.0,174,1,28,29
Remember when Mark Viverito used shady backroom deals to kill even the weakest police brutality reform package after the  movement? #RightToKnowAct #MMVlegacy,3,1,4,-0.25,158,1,13,14
"
Omg #Untouchable  #Eminem #Racism #RacistLeos #EndWhiteSupremecy excellent rap. Goosebumps #KneelWithKap  #TakeAKnee",0,0,0,1.0,118,0,19,19
"This was written at one of my campus' bathrooms. Almost no one says being White is not okay. I think social justice activists, me included, want people of color & other systematic & socially oppressed groups to be accepted & equal in legal & social spheres.  ",0,0,0,-0.009375,259,0,7,7
" 

Justice being served.

",0,0,0,0.0,30,0,4,4
"The 'Racial Cleansing' That Drove 1,100 African American Residents Out Of Forsyth County, Georgia  
#BlackTwitter #blackish ",0,0,0,0.0,125,0,18,18
"This has to stop. 

#theresistance #geeksresist #resist #VetsAgainstTrump 
@Colinkaepernick7  ",1,1,2,0.0,97,0,8,8
"Starting at midnight on Sunday, December 10, we will proudly light our dance floor in ?blue? in solidarity with @HRW on #HumanRightsDay! ??? #StandUp4HumanRights #LGBTQrights  #TransLivesMatter ",4,2,6,0.25,194,1,24,25
"The Brutal Police Execution of Daniel Shaver ?

Sadly I've studied 100s of videos of American police executing non-violent, unarmed people. This is one of the worst I've ever witnessed. ??

#USA #Racismo #Racism #MeToo #blackish #BLM  ",4,4,8,-0.59375,239,0,24,24
"This is insane. Racists are nuts. Oh, and yes,  ",0,0,0,-1.0,48,0,6,6
Every damn day we fight. #Justice4PatriciaHill  ,0,0,0,0.0,48,0,7,7
"If you?re horrified by Daniel Shaver?s untimely death, yet against Black Lives Matter, consider that Shaver might well be alive if only the Mesa police department had long ago adopted reforms of the sort that  suggests.


#USA #Racismo #BLM ",5,1,6,-0.029166666666666664,244,0,18,18
"This needs to stop, systematic racism can't happen in 2018. Justice for Pedro Pierre.  ",0,0,0,0.0,87,0,7,7
Some white people are big mad that Amazon's 'Alexa' believes   ,79,34,113,-0.20833333333333331,63,0,6,6
"#StayWoke: Former President #Obama Warns Voters of Nazism in #America! 
 ",0,0,0,0.0,74,1,10,11
"Please support those impacted by jail violence
@PowerDignity

",1,0,1,-0.1,65,0,6,6
"Daniel Shaver, A white man falls under ",0,0,0,0.0,39,0,6,6
"2017 recap.

  #ItsOKtobewhite #Amazon #Alexa #WTF #twothousandseventeen #fucked #SorryNotSorry #KillMePlease #Goodnight ",5,0,5,-0.55,123,0,18,18
"?You can?t learn to be an ally in a bubble. You can?t read it in a book. It?s about practicing and getting feedback. When you know better, you do better.? -@herhighnessDon #NSEC17 ",4,3,7,0.5,180,0,12,12
Yay....just ordered this!!! #blm  ,0,0,0,0.0,34,3,1,4
We will get your #voice heard on #Facebook and #Twitter. Contact us for more details on having your comments in the #spotlight!  #notmypresident  #ally #lgbtq #socialjustice #loveislove #lovewins #activist,0,1,1,0.625,205,1,4,5
How can you be confident if you?re missing this??  @BrownGirlBlogs #BlackTwitter  #confidence #Motivation #motivational #inspiration #inspirational #WOC #BlackWomenLead #browngirlbloggers #FridayReads #FRIDAY #FridayNight,0,0,0,0.26666666666666666,221,0,26,26
Activists Continue Push for  Agenda in Campaign - NBC News ,0,0,0,0.0,59,0,12,12
"The best way to applaud this company's noble effort at saving both officer and civilians' lives: $LLLI Get onboard. ??????????

 #BlueLivesMatter #MyLifeMatters ",1,0,1,0.8,163,0,15,15
It's about time police are held accountable for their actions. #WalterScott  ,0,0,0,0.0,77,0,6,6
Show up tomorrow to protest against modern day slavery in Libya. We are marching to break the chains #ANTISLAVERY   ,25,14,39,0.2,116,0,17,17
Justice for #DanielShaver who was murdered by a cold-blooded madman with a badge. ,4,0,4,0.0,82,0,6,6
"Don't  as much when it is #Muslims doing the genocide, enslavement, torture, and trafficking? Or does #Islam get a pass (again)? ",17,26,43,0.2,129,2,7,9
"EPIX HD: watch 1000?s of BIG movies like Selma Online!  #FreedomFriday
 ",0,1,1,0.0,73,1,16,17
"i've watched this video and it's DISGUSTING. how can this man be acquitted? i can't wait to see what @TomiLahren, @FoxNews & the likes have to say about this CRIME. fyi, when we were saying that  it was to protect EVERYONE. #ColinKaepernick ",0,0,0,-1.0,241,1,32,33
"Your move, #AllLivesMatter.

 #ACAB #FuckThePolice #DanielShaver 

",3,0,3,0.0,71,0,16,16
"#NYC 

Face to Face with A Child?s Untimely Death in ?Letters in the Dirt? (The NoPro Review): 
Aiyana Mo?nay Stanley-Jones is dead and she needs our help



 #immersivetheatre #interactive  #review @TheTankNYC ",0,0,0,-0.2,218,0,24,24
"Funny how the only people calling for justice for #DanielShaver are  folks when allllll those ""BUTWHATABOUTWHITELIVES?!"" people are nowhere to be found ? ",46,11,57,0.125,154,2,28,30
BBC News - Daniel Shaver: Police officer not guilty of murder   ,1,1,2,0.25,64,0,10,10
"Remember when their articles provided that Ohh..ah Ha..moment?
Like..hey..now..self-determination wins. 
Greece alternative economics
#Indigenous Led resistance 
#NoDapL
ICE
 
#j20
RNC
Digital security 

The List goes on....and on... ",3,0,3,0.15,245,1,22,23
Couldn?t be more excited for @herhighnessDon?s keynote at #NSEC17 after her amazing talk last year and because .,4,0,4,0.36875,112,0,9,9
"Over and over, I see black folks who advocate  being just as vocal when white folks (like #DanielShaver) are killed by police. It's white people whose advocacy less often crosses racial lines. Hence the hashtag.",148,60,208,-0.10666666666666666,211,0,9,9
"If you're going to hold more regard for @realDonaldTrump than @repjohnlewis in the context of Civil Rights (or any, context, for that matter) then you're not only a moron, but you're also a racist. 
#Resist  #BLM #ImpeachTrump",12,4,16,-0.10000000000000002,227,0,14,14
Williamsville church's 'Black Lives Matter' sign vandalized - WBFO   ,0,0,0,-0.16666666666666666,69,0,11,11
"All those crying ""oppression"" & victimhood infected  fuckheads who use ""Slavery"" as an excuse for their backward & criminal attitudes, abuse #USA for their miseries. But none want to go back to #Africa that they miss so terribly. ",1,1,2,-0.33,230,0,10,10
"oh na read this timeline, y?all. #FreeDaairra #FreeCyntoia  #BlackGirlsMatter #injusticesystem ",8,6,14,0.0,95,0,10,10
I cannot watch the video. How on earth does the judge justify not showing this evidence during trial??  ,0,0,0,0.0,104,2,5,7
"People hate so much and gain nothing from it. Just anger and empowering the hater. 

#fridayfeeling #racism  #Melanin #Beyonce #amreading #Sagittarius #LifeEsidimeni #InfluentialFridays #indigochild #Spirit #RisingTogether #HappyMinhoDay #fashionblogger #blogger",0,0,0,-0.43333333333333335,264,0,18,18
"Maybe it?s time to empathize with the  movement 
If a cop can walk Scott free after executing a sobbing unarmed inebriated teenager then nobody is safe
#danielshaver ",1,0,1,0.45,168,0,6,6
Reminder this is happening tomorrow? #Libyablackslavetrade #slavery  #march #protest #antislavery ,3,2,5,0.0,98,0,3,3
"It's time to denormalize republicanism
",0,0,0,0.0,40,0,4,4
.@realDonaldTrump will be livid at this news !  ,0,0,0,0.0,48,1,5,6
"Man, pretty soon all the racist white people are gonna hate Eminem too.. #Untouchable ",1,0,1,-0.18333333333333332,86,0,4,4
"Your daily reminder that #culturalappropriation is an #SJW lie, there is only two genders #nonbinary , modern #Feminism want to ruin the world, #Antifa and  are terrorist",0,0,0,0.06666666666666668,170,0,9,9
"Think Smart and Live!  Respect Yourself !
 
#religion #peace     #alm    #faith",0,0,0,0.21367694805194806,81,2,5,7
The #CulturalIQ Daily is out!  ,0,0,0,0.0,31,1,5,6
"Ex-#police officer gets 20 years in death of black man

#MichaelSlager #WalterScott #shooting 

 ",0,0,0,-0.16666666666666666,101,0,8,8
"American police are not guardians of law and the public.
They are state-endocered thugs, and nothing more.
",0,0,0,0.16666666666666666,109,0,5,5
"Ex-#police officer gets 20 years in death of black man

#MichaelSlager #WalterScott #shooting 

 ",0,0,0,-0.16666666666666666,101,0,8,8
"Make plans now to join us on Monday for a free screening of @WhoseStreetsDoc. Told by activists and leaders from the  movement, ?Whose Streets?? is an unflinching look at #Ferguson. Details here:  ",1,0,1,0.4,197,1,13,14
"On the days that end in Y, #IAmRootingforEverybodyBlack #BlackFriday #BlackTwitter  ",32,6,38,0.0,84,0,14,14
"This is why we fight. 
@SacPolice @sacsheriff complicit in cycles of abuse and torture. 

 
#Justice4PatriciaHill ",38,41,79,0.0,118,0,9,9
Is BLM really about all black lives or just the male ones. ,3,0,3,0.011111111111111118,59,0,7,7
"Critical decision yesterday after police officer sentenced for the shooting of #WalterScott. Even more than demanding accountability in cases of police brutality, we must work towards a day when the marginalized will be completely free.  ",3,1,4,0.3,238,0,7,7
"When racist white folks call black folks ""racist niggers"" 

#TrumpsAWhiteSupremacist #AltRight #Bigots #Merica #VetsVsHate  ",2,0,2,-0.08333333333333333,126,0,13,13
Just watched the last moments of #DanielShaver ?s life. What the fuck is all I can say. I need #AllLivesMatter to turn the fuck up. Where?s that adversarial energy y?all had for ? Asking for myself.,1,0,1,-0.26666666666666666,198,1,14,15
This is what  is all about. It?s about police brutality. Not black people being better than and if you can?t see that then you?re an idiot,0,0,0,-0.07222222222222223,138,0,6,6
"All you black women on here preaching black lives matter just wasting your time, when was the last time you heard a black man preach about something that didn?t affect him. You saw how they treated the woman Nelly raped. #We?reNotOnTheSameSide ",1,0,1,-0.125,244,0,12,12
"It finally happened--a cop (in this case, a former cop) got a conviction and prison sentence for shooting and killing an unarmed black man.  

",1,0,1,-0.05555555555555555,145,0,4,4
"All you asshole Leftists who have been screaming about cops killing unarmed BLACK MEN. Where is the OUTRAGE for this UNARMED WHITE MAN who was shot and killed by a cop?  along with the rest of you fake ass activists can kiss my ass...
",6,3,9,-0.21666666666666667,236,1,36,37
Thank you @jasleengrewall @nadya_agrawal @KajalMag 4 feat #DeepBlueShe #Mutiny2Unity music video/the 100+ artist/activists in it! @TaranaBurke 4 #MeToo #TimePOTY  #womensrights #diversity  #LGBTQ  #StandingRock @thefawz @valariekaur @aswadhin @ShankarAnoushka ,2,1,3,0.0,260,1,29,30
"Voter: ""When was the last time America was great?"" Roy Moore: ""I think it was great at the time when families were united?even though we had slavery?they cared for one another...Our families were strong, our country had a direction."" #nevermoore ",0,0,0,0.5083333333333333,246,1,7,8
"Watch NYXT for #HumanRightsWeek: our partners are shining a spotlight on , #disability rights, #humantrafficking, anti-#LGBT violence, the prison industrial complex and more now:  #HumanRightsDay ",0,1,1,0.1,196,0,18,18
Nah. Y?all better find my brothers and sister !  ??? ,0,0,0,0.625,53,1,18,19
#sayhisname             Daniel Shaver. Unarmed man excuted without process or trial by cops. Horrendous. #stopkillingblackpeople ,1,0,1,0.0,129,0,7,7
We write Shakespeare (a black woman) and @jamarbn78 (a closet republican) responds with hate.  ,0,0,0,-0.4833333333333333,95,0,5,5
"We live in constant poverty,influenced by education,culture,a broken systems,war,disease,exportation ,bribery& corruption.",0,0,0,-0.08787878787878789,122,0,4,4
Wer'e a community with a policing crisis. Another young black man dies after contact with the @metpoliceuk  #Justice4Nuno #NoJusticeNoPeace #PoliceBrutality,9,9,18,-0.033333333333333326,156,0,13,13
 all lives matter but not in the 'land of the free' #Trump ,2,2,4,0.4,59,0,4,4
White People Kills Me With The ?White Privilege ?!!! But You Got The Wrong Black Lady !!!  #Blacktwitter ,1,0,1,-0.2063802083333333,105,6,17,23
"Truth about #healthdisparities. #HealthProfessionals bear responsibility for this change in how they choose to treat ALL their patients.
Nothing protects black women from dying in pregnancy and childbirth 
 #MaternalHealth",2,0,2,-0.16666666666666666,224,0,12,12
"#NAACP #AMJoy #CNN #NYTimes #MSNBC #Maddow #Hardball
#Racist  thug steals weapons from off duty cop & thinks it?s funny. Says he stands with #Kaepernick 
",0,0,0,0.25,156,0,27,27
"This is fucking sick, when are we going to get involved @Conservatives and help sort this out. Also @jeremycorbyn where are you?re thoughts and comments on this?  ",0,1,1,-0.7142857142857143,163,1,6,7
 - An exploration of the  movement and social theory ,0,0,0,0.03333333333333333,53,0,20,20
A country that continues to allow its police force to execute its people without consequences is no democracy #DanielShaver  #StopKillingUs ,2,0,2,0.0,140,0,6,6
??Yes! Yes! Yes! #nonviolentresistance #peacefulprotest #SpeakTruth  ,3,0,3,0.0,69,3,8,11
Despite some of the wacky stuff  has done they started  out for a good reason. Every race has suffered unnecessary death at the  hands of cops not acting with restraint. The GOP would be wise to find a  way to strike a deal with #BLM. It would benefit all of us.,3,0,3,0.3,262,0,13,13
The fact that this guy?s skin color is the reason very few people know of this incident is a huge problem. This is just as outrageous as Eric Garner #AllLivesMatter #HumanLivesMatter  ,2,1,3,-0.2866666666666666,184,0,13,13
I wonder what  are doing to tackle the Africa slave trade?,0,0,0,0.0,58,1,5,6
?????? It?s a start.  ,1,0,1,0.0,22,0,4,4
Just because black-on-black crime is an issue doesn't mean the cops don't have to do their jobs right  #UWBintroESau17,0,0,0,-0.01339285714285715,118,0,7,7
those videos always make my heart hurt and my stomach drop never should someone's life be taken away so unjustly especially by cops who have so many ways they can deescalate a situation and restrain someone without so much force  & fuck you if u think otherwise,3,2,5,0.07499999999999997,261,0,1,1
"Remember all the times @UR_Ninja showed up?
 #NoDAPL and so many more. Support Independent Journos ",27,14,41,0.3333333333333333,100,1,15,16
"Rulers of #Illinois (Bruce Rauner) and #Chicago Illinois (Rahm Emanuel), hope the #Negro never sees this #video:  ",0,0,0,0.0,114,0,9,9
Today's example of why we need an inclusive movement to end police violence rather than isolated movements like  . We are stronger united. ,1,1,2,0.0,139,0,5,5
Black ppl can be used as beards to deflect someone's racism. Don't be somebody's beard. ,0,0,0,-0.16666666666666666,88,0,5,5
"#RoyMoore ~ ?I think it was #Great at the time when families were united. Even though we had #slavery, they cared for one another.""

#Psychology #FridayFeeling #AntiBlackRacism #Morality #MentalHealth  #BLM #BLMTO #CdnPoli #MCGA #MAGA #Culture #AbLeg #Elxn43 #Law",0,0,0,0.8,265,0,40,40
"Yet, THEY still love him. So, who's the fool?  ",1,0,1,0.5,47,1,9,10
Not Like This - #NoPrideHere By  NYC ,0,0,0,0.0,37,0,13,13
White supremacy exposed!!!  ,1,2,3,0.0,28,3,4,7
Ty Gil #WeShallOvercome In Hard Times    #Democracy #WomensRights #LGBTQRights  #Climate #Science #Peace ??????  #SaveOurDemocracy #ThisIsIt #SaveNetNeutrality #YourInternet = #Democracy STOP #GOPTaxScam #isms ,1,1,2,-0.2916666666666667,210,0,44,44
Finally a little bit of justice.  ,0,0,0,-0.1875,34,0,4,4
"?#Racism in the United States has been widespread since the colonial era... Members of the Ku Klux Klan, you should have expected us #Anonymous #OpDomesticTerrorism #OpAltRight #OpKKK #WhiteSupremacy #NazisIntheUSA #NoKKK #NoNazis   ",3,3,6,-0.1,233,0,34,34
"HEY #AllLivesMatter where you at?? Leaving  to do the work as USUAL. 
Also MISS me with that ?Blue Lives? & ?All Lives? BS. ",1,2,3,-0.125,125,2,26,28
"Anyone who doesn't believe in  and counters with #AllLivesMatter , how about you consider what happened to Daniel Shaver, and wonder again if militarizing police and giving little training in de-escalation to cops is a good idea. or do just #BlueLivesMatter ? ",2,2,4,0.25625,260,1,12,13
"Former South Carolina police officer Micheal Slager has been sentenced to at least 19 years in jail for the shooting in the back of Walter Scott.

 #PoliceBrutality #racialjustice",0,0,0,-0.1,181,0,12,12
Weekend read for everybody! I love this paper so much! #infolit  ,3,0,3,0.375,65,2,5,7
"Where are you #WhiteLivesMatter or #AllLivesMatter supporters???? This is why we protest against police brutality, because men like #DanielShaver face injustice and die at the hands of police officers. This is one of the many reasons we say ",1,0,1,0.5,241,4,14,18
"James Arthur Jimmy Baldwin (August 2, 1924 ? December 1, 1987) was an American writer and social critic.  #BlackGirlMagic ",2,4,6,0.016666666666666666,122,0,13,13
progress  ,0,0,0,0.0,10,0,3,3
This was the first time in a while I?ve found myself needing to look away from something because of the horror it contained. I will never understand how this isn?t murder. Never.  ,4,5,9,0.25,180,0,7,7
THIS IS WHY THEY KNEEL!  ,0,0,0,0.0,25,1,21,22
Long as it?s not another black persons taking a black persons life   and that shit is sick,0,0,0,-0.2595238095238095,90,0,4,4
#Alabama #Republicans # Democrats  #Women . . .  Moore's incredible 'even though we had slavery' quote @CNNPolitics ,1,0,1,0.9,116,0,10,10
Is this the last piece to your confidence puzzle??  @BlacksWhoBlog #BlackTwitter  #melaninpoppin #HBCU #hbcus #FridayFeeling #FridayReads #bloggers #Motivation #motivational #Inspire #inspiration #confidence #selfesteem #BlackWomenAtWork,1,0,1,0.0,237,0,23,23
Michael Slager's conviction for killing Walter Scott is a rare example of police accountability.   ,0,2,2,0.3,99,0,7,7
"There was no reason for this! The man could have safely been cuffed when lying on the ground. Instead he was terrorized, scared, confused, & made a mistake that didn?t deserve a death sentence.  ",0,0,0,0.04999999999999999,195,1,6,7
White Privilege 101  #WhiteSupremacy #WhitePrivilege #Negus #Law #System ,0,1,1,0.0,73,0,12,12
WATCH- Barbary Coast Muslims Making a Killing Auctioning Off Enslaved Africans *VIDEO* #Libya  #Slavery  ,0,0,0,0.0,105,0,24,24
"""For people with disabilities, particularly men of color, the experience of arrest is extraordinarily common. They are constantly exposed to this risk.""  #DisabilitySolidarity #CripTheVote ",17,21,38,-0.04583333333333334,189,0,10,10
"""For people with disabilities, particularly men of color, the experience of arrest is extraordinarily common. They are constantly exposed to this risk.""  #DisabilitySolidarity #CripTheVote ",22,21,43,-0.04583333333333334,189,0,10,10
U.S. Black Mothers Die In Childbirth At Three Times The Rate Of White Mothers : NPR -   ,1,0,1,-0.08333333333333333,88,0,21,21
"Say their name. Crayton West, 2016-01-17 .",0,0,0,0.0,42,0,6,6
"I want to cry and scream, and hug every black person I know. then fight how ever I can for change.

",0,1,1,-0.16666666666666666,102,0,3,3
" uses a fist emoji, because it's inherently violent
#AltRight ?? uses a love heart, because... ",19,4,23,-0.15000000000000002,96,0,5,5
#Eminem Rants Against White Privilege in ... #BigHollywood  #ColinKaeperncik #DonaldTrump #news  ,1,1,2,0.0,97,0,14,14
Now that an unarmed white man was shot and killed by a cop and the cop walked I wonder what the #AllLivesMatter crew has to say. In the meantime  crew will speak about about this injustice.,0,1,1,-0.1,189,0,9,9
It should have been life!  ,0,0,0,0.0,27,1,4,5
", #UnfairAndLovely, #SayHerName, #DefendDACA and the nearly fresh #TakeAKnee are scarce a hardly any instance of hashtags that chalk up pushed cultural relocation into the vanguard of mainstream info reporting and elegance via community media ? s...",1,0,1,0.0361111111111111,249,0,17,17
The latest Dope Sheets!   #shesgottahaveit,0,0,0,0.625,42,1,3,4
Love is always a demonstration - not just a set of words or a feeling. #TrapaDrive #BlackLove #BlackGirlsRock #BlackGirlMagic #WCW #WCE ,15,5,20,0.5,136,0,20,20
Investigation launched after young black law student dies in police custody: Another one dead and nothing said.  #Justice4Nuno #NoJusticeNoPeace #PoliceBrutality ,20,23,43,-0.08888888888888889,162,0,13,13
This is why  exist. How is this NOT murder? When will this stop? ,2,0,2,0.0,65,2,9,11
"Capitalism Sucks!
#nurses  #1u @MassNurses @PDA_Mass @Boston_DSA @PVDemSoc ",5,2,7,-0.375,76,1,19,20
"I don't #date nor #marry #Black #Women, but....!!! 
.
.
.
#BLM #blackwomen #women #CeCe #CeCeFerrari #blackpower #melanin #wakeup #love #blackisbeautiful #blackunity #blacklove #blackconsciousness #alllivesmatter #blackpride #blackhistory ",1,0,1,0.08723958333333337,243,3,27,30
"I guess cops killing unarmed men and getting away with murder isn?t just exclusive to . 
",0,0,0,0.0,90,0,4,4
#WinterBreak  official starts today......... But won't rear cause I have to study for #GRE . Its worth it.... #Gradschool  #immigrants #refugees,1,0,1,0.3,144,0,12,12
"Freedom is ultimately endangered when a people place too great an emphasis on rights and too little on responsibility 
Make ",0,0,0,0.2041666666666667,125,0,5,5
"This is something everyone living in this country needs to see.
That being said, it's one of- if not THE- most horrific, senseless, heartbreaking & heartshattering ""cops killing unarmed black kids"" video I've seen so keep that in mind if you choose to watch it.  ",1,0,1,-0.2222222222222222,264,0,9,9
 now too,0,0,0,0.0,8,0,0,0
[#podcast] Will #leadership embrace the opportunity that #diversity represents?  #career #women  #marketing #branding,0,0,0,0.0,117,1,1,2
"New blog post up!



 #Blog #MichaelBrown #Ferguson",0,0,0,0.17045454545454544,55,1,8,9
"""Big Sean"" Let's give em somethin to talk about 
If  Drain The Swamp Alabama #ALSen ",0,0,0,0.0,85,0,14,14
"An Open Letter To Joe Scarborough: This Is More Than About Mike Brown 
  #MustRead",0,0,0,0.25,83,0,18,18
?JUDGE JUDY rules MATT LAUER - NOT GUILTY!? ?HEY MATT -  2!????#mattlauer? ,0,0,0,0.390625,75,2,50,52
"Both #MeToo and  remind us that power corrupts and absolute power corrupts absolutely. Let's hold one another accountable for how we use our power. If we do that consistently, we can avoid much suffering, now and in the future.",0,0,0,0.17,227,0,8,8
End police brutality!!!  ,5,5,10,0.0,25,3,4,7
"Finally justice for #WalterScott, shot and framed by a dirty cop.  ",0,0,0,-0.3,67,0,3,3
 #WhitePeople are shot by police as well when they dont follow police instructions there is no #WhitePrivilege ALWAYS FOLLOW POLICE INSTRUCTIONS  #mega #maga #MakeAmericaGreatAgain #FridayFeeling #FridayThoughts #BlueLivesMatter ,0,0,0,0.0,229,0,48,48
"
Where is @BreitbartNews for #DanielShaver where's #AllLivesMatter and #WhiteLivesMatter for him. He was shot in cold blood. Hopefully #blm  can realize it's not the color black, but the color blue that needs to be focused on @BLMLA @BLMNYC",1,0,1,-0.25555555555555554,241,0,27,27
if you want to have a real racial discussion first you must understand that ?black? and ?white? have nothing to do with skin color...understanding that if someone said ?he is black? they would be saying you were ?evil cursed  cold hearted? #FridayFeeling ,0,0,0,-0.2119047619047619,255,0,5,5
It's about time.  ,1,0,1,0.0,18,0,4,4
"Painting an entire group as BAD the using it as excuse to torture, enslave etc then blame victims of after effects of Trauma #TRUTH  #Nativelivesmatter",0,0,0,-0.25,151,0,12,12
"well how about, thank  you @xijinping for the garden light,
champions of the most exalted #PPI
*meow*
sent one to of the 3.5+Billion Princesses, my Daughter, champion of  & desires to be a makeup artist, maybe even like @bjork &lt;3
Cheers!",1,0,1,0.5125,244,1,7,8
To ALL Trump Supporters & Fox News: If Trump never committed a crime then no one can dig deep and find one he committed. Stop this witch hunt nonsense! #resist #TheResistance  #news #BREAKING #BreakingNews #Mueller #MuellerInvestigation #politics #foxnews #cnn,1,0,1,0.0,260,1,29,30
"Let the record show, I have yet to see any cop who is apart of #BlueLivesMatter condemn #PhillipBrailsford 
You know the same way they want  to condemn every black murdering cops 

#DanielShaver ",58,31,89,-0.08333333333333333,198,0,13,13
"Yesterday, I found hope in #WalterScott's murderer seeing justice. Today... well, fuck. #DanielShaver deserves better than this corrupt injustice system  ",0,0,0,-0.13333333333333333,154,0,10,10
".@MooreSenate said the last time America was great was during slavery. Finally, a man with the courage to speak the truth about @realDonaldTrump and the @GOP?s policies.
#MAGA #NoMoore #TrumpSexPredator #Racists4Trump  #TrumpRussia #ImpeachTrump #VoteDougJones",6,0,6,0.26666666666666666,261,0,30,30
SO MUCH #BLACKEXCELLENCE ?????? #BlackPanther #BlackPantherSoLit  ,6,4,10,0.2,66,0,30,30
" 

what a tragedy we live in ",0,0,0,0.13636363636363635,31,0,3,3
"If you can?t be in the streets, you still can help us fight. 

 

Donate here ",16,12,28,0.0,82,0,2,2
"than white people. However, behind all the funny jokes and scenarios in this episode, is something more racial. The episode, The Gang Turns Black, shows how difficult it is to black in America and shows some issues that have happened before.  (2/2)",0,0,0,-0.06904761904761904,248,0,10,10
"Grace Horse is the perfect gift for your passionate and community service driven loved ones. They will enjoy reading the author?s trials and truths of his faith walk and the justice system of Georgia.

#GiftGuide  #SocialJustice  #DavisSimmonsPublishing ",0,0,0,0.5125,256,0,14,14
 #AIRITOUTRADIO #rap you don't need street cred when you got money ,0,0,0,0.0,67,0,13,13
Stay tuned for the big announcement!! #bepatient #TrustTheProcess #imrootingforeverybodyblack  ,0,0,0,0.0,95,2,7,9
#BlackTwitter #AlabamaValues #Alabamaelection #ALSenate  but don?t do anything radical like get out and vote or anything ,0,0,0,0.0,121,0,11,11
.@ScottAdamsSays is officially working directly with the New York Chapter of  @HawkofNewYork to help make things better. Watch Scott's presentation on how to help his teammates here. Let's see what we can do! ,0,1,1,0.2871212121212121,209,1,15,16
"How would you describe the resistance movement in the US? 

@MichaelSkolnik joins @AJStream Monday to discuss: 

#NotMyPresident
#MeToo

#DefendDACA
#HereToStay
#MuslimBan
#SaveACA
#TaxReformScam

and more. ",13,11,24,0.5,220,1,34,35
another platinum track!  #followforfollow #likeforlike #newmusic #edm #drake ,2,0,2,0.0,77,1,0,1
"#TheResistance #AltLeft #antifa #feminist  #democrats are IMPLODING from #SexualHarassment, #pedophilia, #corruption & #scandal in #Hollywood & #WashingtonDC?

But the #Biased #liberal ""#MSM"" #NYtimes thinks ""The G.O.P. Is Rotting""??????#LiberalLogic ",0,1,1,0.0,253,1,37,38
 for Your information-@realDonaldTrump is delivering on Promises to build jobs jobs jobs for All-especially minorities. If BLM is still against that then #BLM misrepresents itself! Which is it??? ,1,0,1,0.0,196,2,16,18
"Ok white folks, NOW can you empathize? I see some comments saying things like ?I would have been shot? and ?Why was that cop escalating the situation??
#HandsUpDontShoot  ",0,0,0,0.25,172,2,14,16
Great talk on empowering people to address real-time community needs @strtwyze @AntwiAkom  ,2,1,3,0.8,91,0,6,6
"What can Libya?s ?slave auctions? tell us about the humanitarian system?

@Nanjala1 via @IRINNews 

| #Libya   #Racism #ReShapeAid 

",3,4,7,0.0,139,1,16,17
"I hope not. Because if it IS, im gonna go OFF. ?
#blm  #resist  ? #slavery ",0,0,0,0.0,76,0,10,10
damemagazine: Why the NFL?s promise to set aside $89 million toward Black causes is historical via draytontiffanie:   #NFLBoycott,0,0,0,-0.08333333333333333,129,0,9,9
Prediction:  will ask all the questions; not that they don't already know the answers.  ,0,0,0,0.0,88,0,4,4
 #NativeLivesMatter and we must #EndWhiteSilence because my fellow white folks need to use our privilege to change this. This is not ok. ,2,1,3,-0.125,137,0,10,10
Good Morning I hate police officers  #PedroPierre,6,1,7,-0.05000000000000005,49,0,8,8
Why the @NFL?s promise to set aside $89 million toward Black causes is historical via @draytontiffanie:   #NFLBoycott,0,1,1,-0.08333333333333333,117,0,9,9
"Jurors in doctor's civil trial overwhelmed by photos, details of 8-year-old's torture slaying   ",0,0,0,0.0,96,0,4,4
Beautifully written! Thank you @Toure   #tytlive ,23,10,33,1.0,49,1,6,7
ICYMI: We met with Brittany Ferrell from the amazing @WhoseStreetsDoc now available on Netflix   ,0,1,1,0.5,97,0,15,15
Ball and chain @FirstTake pretty tasteless art work for this discussion. Why would you put a chain on Lonzo?s leg? ,0,0,0,-0.175,115,1,8,9
"You can be non-violent, unarmed, comply with every command, and still be murdered. 

And people wonder why players kneel, why , and why people don't respect or trust police as much these days. ",2,0,2,0.2,195,0,5,5
"A lawsuit against the St. Paul, Minnesota Police Department says the dog attacked Desiree Collins while she took out her trash.    #ACAB #PoliceBrutality ",3,2,5,0.0,154,0,17,17
Please Please Please - if you are a person of color in Alabama or love or know someone who is:  GET OUT THE VOTE!!  #NoMoore2017   ,0,0,0,0.78125,131,2,22,24
Gabrielle Union: Only White Women?s Sexual Assault Stories Could?ve Been Taken This Seriously  ,0,0,0,0.04166666666666667,95,0,16,16
"Someone is mad on the internet. lol.  @cernovich @zachhaller @jaredbeck.   (He hates black people, supports racist Jones)   
",0,0,0,0.002777777777777796,126,0,3,3
"
Can we attribute the tiniest modicum of this verdict to BLM? If so, the effort was worth it. We need to NEVER quit this one. ",1,0,1,0.3,127,1,14,15
Anti-Poverty: Taking on Inequality from the Bottom Up  - Dec 8. 2017 #nurses  #1u @MassNurses ,0,0,0,0.0,94,0,12,12
"You can look up the video. I?m not posting that. This man was murdered. He didn?t deserve it. His murderer, a cop, was acquitted. There IS a problem with police brutality. Where is All Lives Matter? Guess who does care about Daniel?  we fight for you too Daniel. ",0,1,1,0.0,263,2,18,20
it real life pisses me all the way off that  and #metoo are always referred to in media as a ?movement?.,2,2,4,0.2,104,0,0,0
DeRay McKesson of  Tweets Claim That Virginia Shooter Was White | John Hawkins' Right Wing News ,0,0,0,0.14285714285714285,96,0,19,19
"looking forward, way forward, to vending  #NotMyPresident #nopolicestate #yoga & #Brooklyn necklaces, magnets, key chains & pins for $2 each @ @MaydaySpace Social Justice Holiday Market ",1,0,1,0.016666666666666666,186,0,13,13
"So this is where we are again? Roy Moore said the last time America was ""great"" was during ""slavery""   #GOPP",0,0,0,0.4,108,1,11,12
"the following video is extremely graphic, however needs to be seen by everyone. this is what  stands for and what we fight against. police need to be accounted for their actions #JusticeforDanielShaver ",71,36,107,0.0,202,0,6,6
"Michael Slager and Larry Nassar are going to prison for a long time #SkimmLife
  via @theskimm  ",0,0,0,-0.05,97,0,6,6
"#NoMoore #RoyMooreChildMolester  #BlackTwitter #ALSen #DougJonesforSenate 
Doug Jones is a man who isn?t pandering to Af. Amer.s for photo ops like DOTUS, but #DougJones has ALWAYS been a Civil Rights Advocate! Vote @GDouglasJones #Alabama! ",6,4,10,0.0,242,2,42,44
 #ImwithKap  #BLM Wake Up Americans. Kap says black lives matter while Libyans are holding thousands of black people as slaves like Mohammad did. Libya is his country of origin adopted and brought to USA. #FuckIslam #AllLivesMatter,0,0,0,-0.16666666666666666,231,0,36,36
New study shows that Black women are 3x as likely to die in childbirth  ,0,0,0,-0.010101010101010102,72,0,5,5
End police brutality!!!  ,0,0,0,0.0,25,3,4,7
#Unprecedented Walter Scott Vindicated! Justice at last #WalterScott #CNN #JusticeReform  ,1,1,2,0.375,90,1,15,16
"Black parents always protect their thug children

Don't ever let them bitch to you about justice

#serialkiller  

",0,0,0,-0.16666666666666666,121,0,5,5
"Glad we're now believing women w/ the #metoo movement
Let's also believe blacks confronting police brutality w/ the  movement",0,0,0,0.5,126,0,5,5
"Wht ppl,  & finally there was one small victory today in #SC in the #MichaelSlager trial. The officer that shot unarmed black citizen #WalterScott & #coastguard veteran in the back was convicted. This is why @Kaepernick7 takes a knee #finally",2,0,2,-0.06944444444444442,242,0,13,13
Don?t leave the house tonight without this factor to complete your confidence??  @bbloggersunited #Melanin #FridayOnMyMind #FridayNight #fridayfun #friyay #FridayFeelings #BlackGirlMagic #BlackGirlsRock #woc #BlackBoyJoy #BlackTwitter ,1,0,1,0.1,235,0,24,24
"Michael Slager, Officer Who Shot #WalterScott, Sentenced To 20 Years  ",0,0,0,0.0,70,0,13,13
How America's new generation of #civilrights #activists is mobilizing in the age of Trump.  A Year Inside the  Movement.  via @RollingStone,0,0,0,0.13636363636363635,139,0,12,12
White Manager Displayed Whip to ?Motivate the Black Employees?  #TakeAKnee  via @TheRoot,0,1,1,-0.08333333333333333,88,0,15,15
"Analilia Mejia of New Jersey @WorkingFamilies on fighting carve outs in minimum wage bills: ""we remind these legislators that there is absolutely a  component to this fight"" at #RaiseTheWage 2017",3,1,4,0.16818181818181818,195,0,12,12
Racism is a public health issue.   ,3,0,3,0.0,35,0,4,4
"VIDEO of a black man named OTE Head that was murdered in Chicago on Nov. 3, 2017 because he was exposing the fact that #KennekaJenkins was murdered by the Crowne Plaza hotel staff and the cover-up!!!  ",4,4,8,-0.3255208333333333,201,3,18,21
#ChildMolesterRoyMoore thinks the last time America was great was when we had slavery  #EpicFail  #Racism,0,0,0,0.4,105,0,11,11
Getting myself a @Kaepernick7 Jersey for xmas and I'm excited. #ImWithKap ,0,0,0,0.375,74,0,10,10
A Year Inside Black Lives Matter: How BLM Is Responding To Trump. My new piece:  ,40,28,68,-0.015151515151515154,81,0,15,15
They never really cared about #AllLivesMatter they just wanted to say something to go against  ,4,2,6,-0.1,95,0,7,7
"All I want for Christmas is:
1) Police abolition now.
2) Police abolition now.
3) Police abolition now.
4) Police abolition now.
5) Police abolition now.

#DanielShaver ",1,1,2,0.0,176,0,13,13
Building Movements Without Shedding Differences: Alicia Garza of  ,0,0,0,0.0,66,0,10,10
The G.O.P. Is Rotting: Trump's racist Attorney General caught on video dismissing concerns about police killing unarmed black citizens  ,89,118,207,-0.05833333333333333,136,0,12,12
"LibTards Acting Badly Again
Will They Apologize For The Smear Campaign?
@DNC #DNC #Democrats #DemocratViolence
#NotMyPresident #NeverTrump
@CNN #CNN @MSNBC #MSM
#LGBT #Atheism #Atheist #Atheists
#Resist #TheResistance
#AntiFa 
 ",0,0,0,-0.3499999999999999,236,1,55,56
Black Mothers Keep Dying After Giving Birth. Shalon Irving's Story Explains Why  #blackwomen  #WomensRights #institutionalizedracism  #youdontgetit,1,0,1,-0.16666666666666666,147,0,17,17
"From  to Black Liberation by Keeanga-Yamahtta Taylor - Reviews, Discussion, Bookclubs, Lists ",0,0,0,-0.16666666666666666,93,0,13,13
 Lets help find these THUGS   #mega #maga #MakeAmericaGreatAgain #FridayFeeling #FridayThoughts  #criminallivesdontmatter,0,0,0,0.0,121,0,17,17
"This Is A Christian
@GOP > ""NoSuchThingAsWhitePrivilege"" 
?I forgive you, & I pray 4 you that you will repent and let Jesus come into your life. Just as you are, he will forgive you.?
Judy Scott, mother of Michael Slager to SC police officer who killed her son
",0,0,0,-0.1,265,0,26,26
"Have you seen @WhoseStreetsDoc directed by @sabaahfolayan & @heartacheNpaint? 
 #DirectedbyWomen ",5,3,8,0.0,98,1,10,11
"When you watch this, replay every ""execution"" of unarmed black Americans by police and re-address the purpose of  and @Kappernaker #TakingtheKnee. 1/2 ",0,0,0,-0.16666666666666666,151,0,8,8
Good: #MichaelSlager will go to prison (albeit not for long enough) for murdering #WalterScott.  .,0,0,0,0.21666666666666665,98,0,8,8
"Heartbreaking. This, and blacks being incarcerated at a higher rate, can be traced all the way back to the failed 'reconstruction' period after the Civil War. #history  

Black #Mothers Keep Dying After Giving Birth.  ",0,1,1,-0.10416666666666666,220,0,14,14
Y?all are talking about  but you taking photo with white Santa Claus,0,0,0,0.0,68,0,6,6
"Why did Johnny Morgan have to kill Andrew McGrerrigal? And why are the professors silent?
 via @ColinFlaherty & ",0,0,0,0.0,113,2,12,14
Nothing protects Black woken from dying in pregnancy and postpartum. This is NOT acceptable. #MaternalHealthMatters   ,0,0,0,-0.16666666666666666,118,0,12,12
"Black kids are 7 times more likely to get arrested than white kids in this #Alabama town. 

#School #children #BLM  #Equality #Schools #Education #kids #SpanishFortAL #ALSen #Moore #RoyMoore #Racism #Racist #AlabamaSenate @MooreSenate 

",5,1,6,0.08333333333333334,241,0,28,28
#DanielShaver is the reason there is a such thing as . All the racist idiots complaining about ungrateful @NFL players now see why they kneel.,2,1,3,-0.4,142,0,7,7
Develop an anti-racist vision for your organization by attending this special presentation from @racialequityllc. Tickets are $50.  | #nola #racism ,2,0,2,0.35714285714285715,148,0,5,5
", and Black Health Matters, too: Reproductive Justice  ",4,1,5,-0.16666666666666666,55,0,8,8
"Don't misconstrue my last tweet. I support the police, but the violence against minorities NEEDS to stop.  It is freaking 2017, we do not need to still be talking about this. Get your act together, world.",0,0,0,0.0,204,0,12,12
"EPIX HD: watch 1000?s of BIG movies like Selma Online!  #FreedomFriday
 ",0,0,0,0.0,73,1,16,17
Spend 5 minutes in a HS hallway and you'll hear more foul language than in the pages of this book.  HINT:  It's NOT about the language.   #TheHateUGive ,0,0,0,0.5,152,0,18,18
 and we must stand up against injustice ,0,0,0,0.0,40,0,3,3
"In 15 High-Profile Cases Involving Deaths of Blacks, One Officer Faces Prison Time   ",0,0,0,0.0,85,0,15,15
"I'm rubber you're glue what you say bounces off me and sticks to you.  ""my momma always said, 'stupid is as stupid does.'  #altright #bluelivesmatter  but your life @TheTweetest is questionable. ",0,0,0,-0.6999999999999998,195,0,6,6
Just a reminder that ,5,8,13,0.0,21,0,4,4
 Camps At Police Station For 2 Weeks |  ,0,0,0,0.0,40,0,9,9
"Police are a gang. 
Police are an organization of state violence. 
Scratching ""You're Fucked"" into the barrel of your service weapon should result in automatic termination. 
Daniel Shaver should be home rn.
#DanielShaver  #PoliceBrutality
",1,0,1,-0.6,244,0,14,14
Inside a secret 2014 list of hundreds of L.A. deputies with histories of misconduct  This is horrible. Law enforcement officers who engage in this type of behavior should be dismissed and prosecuted.#decencymatters  #MeToo,0,0,0,-0.7,222,0,10,10
If every cop get 20 years for shooting a Unarmed person  black/white it well defenily stop cops for killing with no regard #facts ,1,0,1,0.0,130,0,5,5
Powerful reporting. Painful truth: U.S. Black Mothers Die In Childbirth 3 time > White Mothers   ,2,3,5,-0.14166666666666666,97,0,14,14
"#AllLivesMatter  was shut down, drowned out, called a ""racist backlash"" against  when they tried to show cops killing innocent people unlawfully isn't a race issue. Now, we only get justice for the black victims. 

Shameful racism in action.",0,0,0,0.029629629629629624,243,0,8,8
"The terrific  drama, CROWN HEIGHTS starring Lakeith Stanfield, is now available on Amazon Prime Video. Here's me on why you shouldn't miss it (via @HelloBeautiful):  ",24,21,45,0.2,166,0,24,24
"I liked a @YouTube video   EXPOSED! Lying About 'Racism,' White Cops...Jasmine Abdullah",0,0,0,0.375,87,1,33,34
"Oh, never mind. You are still in the sunken place ??? 

 #BlackPolitics ",1,0,1,0.0,74,0,7,7
Down with white supremacy! Long live queen @SharonReedCBS46! #ClapBack #Sheroe #Queen  #RoleModel ,3,1,4,-0.00877525252525254,98,2,16,18
"Dear @REALStaceyDash ? Question: you weren?t getting enough love from Trump supporters that you had to come back to the demographic you slammed? Or did Trump stop paying you? Asking for some friends. 

 #BlackPolitics ",0,0,0,0.16666666666666666,220,2,17,19
" ?
the man would NOT follow directions and kept moving his hands behind his back and at his waist sad outcome but was totally justified #BlueLivesMatter #mega #maga #MakeAmericaGreatAgain #FridayFeeling #FridayThoughts #FactsMatter ",0,0,0,-0.125,233,0,19,19
"Finally a fitting punishment. 

 #aclu #PoliceBrutality",0,0,0,0.5,57,0,3,3
Ok Yes @Caitlin__Barlow !  I see you with the ?White Silence = White Consent? shirt representing for  on #TeachersSeries ?? My hubby and I watch @TeachersSeries every week and now we have another reason to love you ladies even more ?????? ,1,0,1,0.325,239,1,18,19
 Parents are just as evil if they refuse to put him behind bars are worse knew and failed to stop him #mega #maga #MakeAmericaGreatAgain #FridayFeeling #FridayThoughts #criminallivesdontmatter  #Serialkiller #Florida,0,0,0,-0.575,216,0,14,14
"If it isn't good news to the poor, restoration for the broken-hearted, sight for the blind, and freedom for the captives, it isn't the gospel of Jesus!  #Justice #Liberation ",1,1,2,-0.10833333333333336,174,1,7,8
via @npr: Black Mothers Keep Dying After Giving Birth. Shalon Irving's Story Explains Why #SeasonOfGiving  #womenrights #humanrights  ,0,0,0,-0.16666666666666666,134,0,18,18
"Hey, look!  Good news sometimes happens! Walter Scott's murderer was convicted!  
",1,0,1,1.0,83,3,7,10
: Black Liberation or Black Liberal Distraction? ,0,0,0,-0.16666666666666666,49,1,8,9
A lot of people are gonna be mad at Eminem for #UNTOUCHABLE realize though  has been trying to get you to listen,0,0,0,-0.625,112,0,16,16
"It was. For people who believe in a hierarchy of humanity, having a well-ingrained caste system supported by an expectation of brutality was certainly a more preferable existence.

#PostRacial #NewSchools #HistoryRepeats #SelfDefense  ",0,0,0,0.5,237,0,13,13
"I watched this last night and again this AM - cannot make it through the whole thing, but will keep trying b/c this is important and this is not an isolated incident.  This is abuse of power from a broken system.   ",2,1,3,0.05000000000000002,215,0,7,7
"Michael Slager, Officer in Walter Scott Shooting, Gets 20-Year Sentence  #NorthCharleston #SouthCarolina ",0,0,0,0.0,105,0,16,16
"The brutality of police killing unarmed, presumed innocent people is a horror which must be addressed and abolished. ALL citizens deserve the right to live without fear. I believe in  &#AllLivesMatter. #policemurderers ",0,0,0,0.3073593073593073,219,0,11,11
"There was this time when black people used to hate on @Eminem  but now that same dude is standing up for the black ones.
Nothing but respect ",12,2,14,-0.2833333333333333,142,0,6,6
THANK YOU @Eminem ,1,0,1,0.0,18,0,12,12
I?m So Sick Of Seeing My Beautiful & Handsome Dark Skin Kings & Queens Suffer ? ,0,0,0,0.1214285714285714,80,0,16,16
"Victory for #WalterScott on Thursday. Friday, no justice for #DanielShaver ... Once again we have to ask, do  ? ",1,0,1,0.0,112,1,11,12
I wonder If It Was A Kill White Police Cops Only How Will America React? ,0,0,0,0.0,73,1,17,18
"Black Militancy was last gasp of Black Intellect.
Opposed by the Negro Priest-Kings who worship their master's god.
Make ",0,0,0,-0.1111111111111111,123,0,12,12
"The ignorant Black people deny the truth about the Black slave trade. THE HIDDEN ISLAMIC SLAVE TRADE & COLORISM @BlackPeopleCare @BlackPeopleRead  
 via @YouTube",0,1,1,-0.16666666666666666,162,0,48,48
"This is sickening me, do something americucks. Nobody cares, because  and whites dont. #justicefordanielshaver ",4,0,4,-0.9,111,0,5,5
"Michael Slager, Officer in #WalterScott Shooting, Gets 20-Year Sentence  ",1,0,1,0.0,73,0,12,12
Tbh I Wonder If There Was A Kill Whites Only Serial Killer How Would America React ? ,0,0,0,0.0,85,1,19,20
#MeekMill's Attorney Speaks After Prison Visit.  ,0,0,0,0.0,49,0,10,10
This happens to black people all the time. This is why all athletes should kneel during the #NationalAnthem WE the people of the United States demand JUSTICE and FAIRNESS. This is disgusting! @NFL @Kaepernick7  #movement ,0,0,0,-0.5833333333333334,221,1,31,32
wikileaks is fuckin racist. i was raped today cuz i?m a POC and TRANSGENDER #metoo #fuckwhitepeople #LGBT ,0,0,0,0.0,106,0,18,18
Refugees deserve a chance at a better life #nototrump2017 #notohate ,0,0,0,0.5,68,0,1,1
"76% Americans strongly support police,incl.67% of POC. Many cops are Black whereas 
 is mostly WHITES. Same freaks as Occupy & Antifa. Watch their Periscopes & see. All decent Black ppl reject BLM. 
 ",0,0,0,0.18095238095238092,202,0,25,25
??Black IS Beautiful in #Ecuador is the LMC's latest episode as we chat w/ Prof Hugo Benavides  #SupportBrownPodcasts #blacktwitter #blacktwitter??,0,0,0,0.675,147,0,17,17
??Check out our latest episode on being Black & Beautiful in #Ecuador w/ Prof Hugo Benavides  #SupportBrownPodcasts #blacktwitter #podsincolor??,8,5,13,0.3944444444444444,144,0,13,13
??Our latest episode on being Black & Beautiful in #Ecuador w/ Prof Hugo Benavides is now available  #SupportBrownPodcasts #podsincolor??,1,4,5,0.39583333333333337,137,0,13,13
"There is no police problem for Bkack folks. That?s a huge lie. Most Black people reject  & strongly welcome & support law enforcement. 
Just like with Whites, only criminals & criminal-supporters hate police. ",1,0,1,0.12222222222222227,210,0,10,10
"????? #Untouchable by @Eminem ??? ""Throughout history African Americans have been treated like shit and I admit there have been times where it's been embarrassing to be a white boy"" @napster #Flamesandfirebars #Newmusic   ?????",0,0,0,-0.06666666666666668,227,0,11,11
"To @Eminem, thank you for your music this morning.  ",0,0,0,0.0,52,0,5,5
"Proud of @EMINEM! ??  #Untouchable #REVIVAL  #MAGA #EMINEM 
",0,0,0,1.0,61,1,28,29
"an unarmed white man was executed by a homicidal police officer and the only people who know about it and demanding justice are  activists. 

i wonder why. 

#JusticeForDanielShaver",1,0,1,0.0,185,0,4,4
HATE U GIVE @angiecthomas was a powerful novel about police violence and how the lives and dreams of African American youth are cut short. A deeply moving tribute to our times with an authentic teen voice. #libfaves17 ,9,1,10,0.0,218,0,15,15
Important Read: A Year Inside the  Matter Movement -  via @RollingStone,3,1,4,0.4,71,0,12,12
 is just a NAME. Anarcho-Commie LGBTQ militants who hate Black masculinity & heterosexuality. They dont give a damn about THOUSANDS of Black males killing each other every year! Here?s one of many examples of BLM hatred of Black men:  ,0,0,0,-0.159375,235,1,31,32
If you can't fight an unarmed man without a gun you shouldn't have a gun. #ACAB #Abolish   #FTP ,1,0,1,0.0,96,0,12,12
Now The Magnificent 7 are gluten-sensitive?? Blocked and reported  ,0,0,0,1.0,67,2,4,6
This is a brutal video. But if you have been skeptical about  then perhaps seeing a white person summarily executed in a horrifying game of Simon Says played by this ?officer? will convince you otherwise? ,2,1,3,-0.5349999999999999,205,1,7,8
#CivilRightsMuseum I stand with #JohnLewis :; We must all protest #Racist @realDonaldTrump being at the opening #Protest ,0,0,0,0.0,121,0,14,14
"If Your #Kids #Children Are Home From School Today, Review THIS With Them! #HoustonSnow #TexasSnow2017 #TexasSnow #Texas #AfricanAmericans  #FridayReads #ItsOnUs #ItsTimeToThrive #TheDecade ",0,0,0,0.0,190,1,39,40
America: where civilians are supposed to be perfectly calm and compliant with a gun pointed at us but authority can be afraid ? ,1,0,1,-0.14999999999999994,128,0,4,4
"Yeah, OK @ShaunKing you suddenly ""caring"" about a white guy is pretty telling. Where were you when Brailsford could have gotten federal charges? Marching in another BLM riot? Only  to you.

",0,0,0,0.15,192,2,15,17
"Watch NYXT for #HumanRightsWeek: our partners are shining a spotlight on , #disability rights, #humantrafficking, anti-#LGBT violence, the prison industrial complex and more now:  #HumanRightsDay ",0,0,0,0.1,196,0,18,18
"This is horrific.
There is no excuse for telling an unarmed cooperating scared kid that if he makes a mistake you will shoot him.
Guess what makes him more likely to make a mistake? But that's what you were going for... #powertrip #policeviolence  ",0,0,0,-0.11875,250,1,7,8
"
There is no defense of this straight-up execution ",0,0,0,0.0,52,0,4,4
"#Trump tours the new Mississippi Civil Rights Museum and says, as he did in Charlottesville, ?You had some very fine people on on both sides.?  @TheRoot @blicqer @usblm @BlackNews #FridayFun #FridayFeeling @NAACP #Alabama",2,5,7,0.33901515151515155,221,0,24,24
"These new @Eminem lyrics are meaningful, hella clever, and dope. But the production on this song is pretty annoying ? to me. Overall the song is cool. ? ??  ",0,0,0,0.08614718614718612,157,0,7,7
"IMAGINE The #JobsReport WHEN #AfricanAmericans Develop Our Future, With @UN #AfricanUnion #FAU etc!!! #Jobs #Wealth #ABetterWay #ABetterFuture #ABetterDeal #AfricanAmericans  #EconomicDevelopment #EconomicJustice #NEWDiasporaEconomy #FridayFeeling #FridayReads ",1,1,2,0.0,261,3,56,59
Chicago used to be one of the nicest cities to live in. Decades of @TheDemocrats in power has ruined it. @CNN @ABC @MSNBC @washingtonpost @nytimes @DNC @CBSNews @BarackObama  @NAACP #BernieSanders #socialism #FreeFood #FreeEducation #freehousing #Millennials ,1,1,2,0.13636363636363635,259,0,39,39
" yellin bout #fuckthepolice.
idk man, @OfficialSting aint that bad. roxanne is a classic.",0,1,1,-0.2666666666666666,90,0,2,2
"As I finish up the syllabus for the course I'm teaching next semester called  and Beyond, I'm struck by how much students need to know BEFORE they can even really grasp the significance of #BLM. #BlackProfessor ",8,1,9,0.13333333333333333,211,0,19,19
?It is because of #NetNeutrality rules that the internet is the only communication channel left where Black voices can...be heard.? @OsopePatrisse of . Keep our movements strong - come out and demand the FCC protect net neutrality. ,0,0,0,0.053333333333333316,232,0,13,13
Ex-officer acquitted in death of man who begged for life - NBC News ? #AllLivesMatter #BlueLivesMatter  ,1,0,1,0.0,104,0,14,14
BEST OF 2017: Shout out to @UndocuBlack for one of the best shows of the year talking about one of the least reported aspects of immigrant rights  #SupportBrownPodcasts ,3,2,5,0.5666666666666667,169,0,15,15
"Ohio police mistake a man's colostomy bag for a gun and taser him.  This kind of brutality happens every. single. day.  
 #PoliceBrutality",0,1,1,0.2642857142857143,139,0,7,7
#FridayFeeling Is That Feeling Of Freedom And Development!!! #FridayReads #AfricanAmericans #FlashbackFriday  #FridayMotivation #BLM #ItsTimeToThrive #ItsTimeToOrganize #ItsTimeToChange #ItsTime #TheDecade ,0,0,0,0.0,206,3,39,42
 where is your outrage? ,0,0,0,0.0,24,1,0,1
He didn?t deserve this. My prayers go out to you and your family baby girl ?#JUSTICEFORPEDRO  ,0,0,0,0.0,94,0,20,20
"EPIX HD: watch 1000?s of BIG movies like Selma On TV, Online!  
 ",0,0,0,0.0,66,1,17,18
"Michael Slager, Officer in Walter Scott Shooting, Gets 20-Year Sentence  ",0,0,0,0.0,73,0,9,9
"Why is @TIME trying to erase #TaranaBurke and she started the #MeToo campaign? 

 ",1,0,1,0.0,84,1,12,13
"The GOP colluded with Russia, Putin, Assange & WikiLeaks. You know if they comitted treason, they don't give a damn about protecting your daughter. #ALSen #NoMooreTrump #NoMoore4AL #NoMoorePredators #NoMoorePedophiles #NoMoore #MobilizeAlabamaDemocrats #Alabama  ",9,4,13,0.0,263,0,35,35
"Thought 4 the day from @joanchittister -- Dissent: ""The establishment is always loyal to the very institutionalism of the institution in  question. The dissenter is always most loyal instead to what the institution itself claims to be about."" #ImWithKap ",0,0,0,0.3416666666666666,254,0,10,10
slavery in usa never happened...it?s a big lie... #FridayBriefing #FridayFeeling ,1,0,1,0.0,81,0,7,7
"Until Doug Jones @GDouglasJones removes his racist ads, #Antifa will refer to him by his Slave Name
 
#Resist 
#Resistance ",6,1,7,0.0,126,0,14,14
"Welcome to the Generation of the Living Dead

#TheResistance  
#Antifa 
#LiberalismIsAMentalDisorder",1,0,1,0.30000000000000004,104,0,15,15
"A poignant piece of how people try to erase blackness to make it all more palitable....but ""it is nevere their intention"".   #blackexcellence #blackbrilliance ",2,2,4,0.25,159,0,4,4
#MeToo last 4 years it was  . next 8 it will be #MeTooMovement ,0,0,0,0.0,63,0,8,8
Prohibition: ?Drinking was something most closely associated with blacks and immigrants such as the Irish and Italians (both largely Catholic). Prohibition was endorsed and enacted by the church and the KKK.? SOUND FAMILIAR? #WarOnDrugs  #itISaboutrace,0,0,0,0.2125,252,1,30,31
WATCH- Barbary Coast Muslims Making a Killing Auctioning Off Enslaved Africans *VIDEO* #Libya  #Slavery  ,0,0,0,0.0,105,0,24,24
"Meet the 17-year-old who is suing her school. She doesn't stand for the #pledge of #allegiance and the school doesn't stop the #bullying doesn't protect her and her right to #FreeSpeech 
 #girlsrule  ",0,0,0,0.2857142857142857,201,0,7,7
Unicorns are real!  ,1,0,1,0.25,20,1,4,5
Go listen to the new song Untouchable by Eminem. Holy crap!  #Politics #MarshallMathers,0,0,0,-0.4318181818181818,87,1,10,11
"This report illustrates why  is so necessary: Black women are 22% more likely to die from heart disease than white women, 71% more likely to die from cervical cancer, & 300% more likely to die from pregnancy- or childbirth-related causes. ",2,0,2,0.14814814814814814,239,0,5,5
"Finally?Real accountability for lethal police violence. The more this happens, the fewer incidents will occur.  ",0,0,0,0.5,112,0,6,6
"Isn't this the #truth #BLM  #BLACKPOWER #BlackTwitter 
#motivation #WeThePeople #weallwegot ",6,1,7,0.0,93,0,22,22
"Dear white people, thanks for let black people go to in your universities / colleges . Colleges is paid with white people tax money while we black people receive subsidies and; not pay tax or / and work.  @meketaton_ @DaveCullen @PrisonPlanet",0,0,0,-0.026666666666666658,242,0,9,9
Mother of #MarioWoods: ?They hate us. They hate us.? #SFPD    #KeitaONeil ,0,1,1,-0.8,74,0,15,15
"EPIX HD: watch 1000?s of BIG movies like Selma Online!  #FreedomFriday
 ",0,0,0,0.0,73,1,16,17
"Just like the FBI monitored the civil rights movement in the 60's.



",0,0,0,0.0,74,0,7,7
20 years for the ????? that shot Walter Scott #JusticeAtLast #WalterScott ,0,0,0,0.0,74,0,10,10
"tw: murder, police brutality

this is fucking disgusting. how can anyone not understand that SHIT LIKE THIS is why  exists!!! bc this keeps happening!!! ",1,0,1,-0.8814697265625,155,6,15,21
When black girls are killed/ sometimes/ the sky opens/ but mostly there is quiet #amwriting  #ResistingArrest,2,0,2,0.11111111111111112,109,0,6,6
Ex-Cop Michael Slager Sentenced In Killing Of Walter Scott   via @NewsOne,0,0,0,0.0,73,0,12,12
Michael Slager's conviction for killing Walter Scott is a rare example of police accountability.    by #ACLU via @c0nvey,2,0,2,0.3,120,0,11,11
"Sessions spars with interns over marijuana policy, police brutality  via @nypost #JeffSessions #Trump #PoliceBrutality ",0,1,1,0.0,119,0,9,9
"The view from my bedroom window (a noisy rail yard) usually sucks. Not today. ?
#PhilandoCastile #KnowMyName  #NeverForget #Tag #GraffitiIsArt #train #MovingMural ",0,0,0,-0.3,164,0,18,18
"what have black people done to receive so much hate... Like in general what have we done? 
 #Black #AfricanFolllowTrain #African #AfricanBeauty #blogger #fashionblogger #fashion",0,0,0,-0.21666666666666665,178,1,11,12
"THIS Is why Kaepernick knelt, this is why so many others joined, this is why  not ?all?.  #DanielShaver ",1,0,1,0.5,104,0,11,11
"Thus far, the ONLY cop to be sentenced to prison for killing an unarmed black man happened to be caught on video clearly shooting the victim in the back as he ran away.

And it still took years and atleast one mistrial. ",1,0,1,-0.006944444444444441,222,0,9,9
"Please consider me next month...!?
#NewYear2018  #blacktwitter  #NoJusticeNoPeace #Poverty ",0,0,0,0.0,92,1,8,9
It?s about damn time we finally get justice within this crooked broken system  ,0,0,0,-0.13333333333333333,79,0,4,4
